neg_dic,Up,Down,total,Polarity Score,Polarity
마이너스/NNG,603,597,1200,0.6585832414816529,Dovish
달라지/VA,70,65,135,0.7021863416639438,Dovish
서둘러라/VV,5,28,33,0.1164339597146845,Dovish
구조법/NNG,12,15,27,0.5216241395217868,Dovish
저축률/NNG,35,80,115,0.2852632013009771,Dovish
안내/NNG,200,205,405,0.6361269994168132,Dovish
순차입/NNG,75,76,151,0.6434508300022042,Dovish
시가총액비중/NNG,11,12,23,0.5976943265353807,Dovish
대외/NNG;충격/NNG,13,19,32,0.4461259088015282,Dovish
디에프/NNG,3,24,27,0.0815037718002791,Dovish
물질/NNG,21,40,61,0.3423158415611726,Dovish
펼쳐지/VV,29,26,55,0.727264425294799,Dovish
천주/NNG,1,21,22,0.0310490559239158,Dovish
떠돌/VV,11,10,21,0.7172331918424568,Dovish
나타난다고/VV,9,8,17,0.7335339462025127,Dovish
강등/NNG,84,132,216,0.4149282928014213,Dovish
열거/NNG,8,11,19,0.4742037632016244,Dovish
거시/NNG;불확실성/NNG,32,33,65,0.6322716842688325,Dovish
정책/NNG;여력/NNG;확보/NNG,10,10,20,0.6520301744022335,Dovish
주호/NNG,14,15,29,0.6085614961087512,Dovish
주의/NNG,231,206,437,0.7311600499364852,Dovish
위험/NNG;높/VA,39,37,76,0.6872750486942462,Dovish
정확/MAG,79,78,157,0.6603895356125185,Dovish
채무액/NNG,4,14,18,0.1862943355434952,Dovish
연체율/NNG;오르/VV,77,72,149,0.6973100476246108,Dovish
물꼬/NNG,21,20,41,0.6846316831223452,Dovish
때로/MAG,13,13,26,0.6520301744022335,Dovish
상해/NNG,29,38,67,0.4976019752017045,Dovish
도루/NNG,6,12,18,0.3260150872011167,Dovish
아베노믹스/NNG,28,45,73,0.4057076640725008,Dovish
크로스/NNG,12,11,23,0.7113056448024364,Dovish
부작용/NNG;우려/NNG,11,15,26,0.4781554612283045,Dovish
견해/NNG,715,841,1556,0.5543419437545742,Dovish
rbc비율/NNG,11,10,21,0.7172331918424568,Dovish
신용위험/NNG,359,351,710,0.6668912609982958,Dovish
보베스파/NNG,7,19,26,0.2402216432008228,Dovish
전문직/NNG,16,30,46,0.3477494263478579,Dovish
政策/NNG,14,17,31,0.5369660259783099,Dovish
입출/NNG,114,114,228,0.6520301744022334,Dovish
심리/NNG;양호/NNG,4,20,24,0.1304060348804467,Dovish
청시/NNG,5,17,22,0.1917735807065392,Dovish
순차입금/NNG,8,25,33,0.2086496558087147,Dovish
장단점/NNG,8,10,18,0.5216241395217869,Dovish
어감/NNG,19,30,49,0.4129524437880812,Dovish
타협/NNG,17,22,39,0.5038414984017259,Dovish
일조/NNG,55,51,106,0.7031697959239773,Dovish
투기지역/NNG,6,12,18,0.3260150872011167,Dovish
금전신탁/NNG,62,69,131,0.5858821856947606,Dovish
일드커브/NNG;스티프닝/NNG,6,12,18,0.3260150872011167,Dovish
실트/NNG,8,15,23,0.3477494263478579,Dovish
대출비중/NNG;확대/NNG,4,20,24,0.1304060348804467,Dovish
순간/NNG,63,67,130,0.6131029998110553,Dovish
해킹/NNG,15,26,41,0.376171254462827,Dovish
신청일/NNG,20,45,65,0.2897911886232149,Dovish
파산보호신청/NNG,7,20,27,0.2282105610407817,Dovish
보좌관/NNG,11,14,25,0.512309422744612,Dovish
위험/NNG;부담/NNG,13,20,33,0.4238196133614518,Dovish
수령액/NNG,10,15,25,0.4346867829348223,Dovish
필립스곡선/NNG,18,17,35,0.6903848905435414,Dovish
상대국/NNG,27,48,75,0.3667669731012563,Dovish
일단락/NNG,41,37,78,0.7225199229862587,Dovish
장래/NNG,15,16,31,0.6112782885020939,Dovish
기준점/NNG,38,36,74,0.6882540729801354,Dovish
소나/NNG,17,49,66,0.2262145503028157,Dovish
대사/NNG,11,29,40,0.2473217902905023,Dovish
계동/NNG,6,18,24,0.2173433914674111,Dovish
금소/NNG,22,20,42,0.7172331918424568,Dovish
약간/NNG,65,78,143,0.5433584786685279,Dovish
선배/NNG,9,8,17,0.7335339462025127,Dovish
해방/NNG,8,13,21,0.4012493380936822,Dovish
복귀/NNG,148,133,281,0.7255674121167711,Dovish
효과/NNG,2482,2180,4662,0.7423572903056622,Dovish
조회/NNG,139,137,276,0.6615488630796383,Dovish
가져갈/VV,41,37,78,0.7225199229862587,Dovish
호피/NNG,6,11,17,0.3556528224012182,Dovish
국제/NNG;유가/NNG;하락/NNG,48,57,105,0.5490780416018808,Dovish
생계/NNG,37,36,73,0.6701421236911844,Dovish
금리/NNG;인상/NNG;배제/NNG,37,32,69,0.7539098891525825,Dovish
효용/NNG,13,16,29,0.5297745167018147,Dovish
주저앉/VV,34,32,66,0.6927820603023731,Dovish
볶음/NNG,17,29,46,0.3822245849944127,Dovish
정치/NNG,670,603,1273,0.7244779715580373,Dovish
원사/NNG,6,16,22,0.2445113154008375,Dovish
예상/NNG;금리/NNG;인하/NNG,27,24,51,0.7335339462025127,Dovish
불안/NNG;금리/NNG;인하/NNG,16,14,30,0.7451773421739811,Dovish
하락/NNG;제한/NNG,28,30,58,0.6085614961087512,Dovish
고용/NNG;감소/NNG,16,14,30,0.7451773421739811,Dovish
혁신성장/NNG,38,42,80,0.5899320625544018,Dovish
원화/NNG;환율/NNG;오르/VV,33,36,69,0.5976943265353807,Dovish
유행/NNG,113,100,213,0.7367940970745238,Dovish
금괴/NNG,10,9,19,0.7244779715580372,Dovish
거치/NNG,18,19,37,0.617712796802116,Dovish
응답자비율/NNG,3,35,38,0.0558883006630485,Dovish
명령/NNG,51,64,115,0.5195865452267798,Dovish
친절/NNG,10,22,32,0.2963773520010152,Dovish
내재/NNG,69,96,165,0.4686466878516053,Dovish
상하향/NNG,4,32,36,0.0815037718002791,Dovish
비주거/NNG,44,41,85,0.6997396993584944,Dovish
계통/NNG,21,28,49,0.4890226308016752,Dovish
수출/NNG;호조/NNG;경제/NNG;성장/NNG,1,19,20,0.0343173776001175,Dovish
완충/NNG,71,92,163,0.5031971998104193,Dovish
황제/NNG,21,50,71,0.2738526732489381,Dovish
봉구/NNG,12,13,25,0.6018740071405232,Dovish
도과/NNG,2,17,19,0.0767094322826157,Dovish
기대/NNG;주가/NNG;상승/NNG,10,10,20,0.6520301744022335,Dovish
세수진도율/NNG,15,30,45,0.3260150872011167,Dovish
엔드/NNG,7,10,17,0.4564211220815634,Dovish
대형화/NNG,11,21,32,0.3415396151630747,Dovish
표표/NNG,7,13,20,0.3510931708319719,Dovish
인하/NNG;그치/VV,11,15,26,0.4781554612283045,Dovish
구조화채권/NNG,4,20,24,0.1304060348804467,Dovish
공신력/NNG,10,12,22,0.5433584786685279,Dovish
유의/NNG,494,663,1157,0.4858264044565661,Dovish
느리/VA,159,140,299,0.7405199837853939,Dovish
이자보상배율/NNG,86,142,228,0.3948915140745921,Dovish
인용/NNG,136,117,253,0.7579154163991774,Dovish
수출/NNG;경제/NNG;성장/NNG,7,15,22,0.3042807480543756,Dovish
모멘텀/NNG,771,728,1499,0.6905429456924753,Dovish
전망/NNG;줄/VV,25,36,61,0.4527987322237732,Dovish
마티스/NNG,3,18,21,0.1086716957337055,Dovish
시군/NNG,16,17,33,0.6136754582609257,Dovish
청약기간/NNG,5,56,61,0.0582169798573422,Dovish
상하위/NNG,10,30,40,0.2173433914674111,Dovish
대전환/NNG,6,16,22,0.2445113154008375,Dovish
북문/NNG,9,16,25,0.3667669731012563,Dovish
금리/NNG;하락/NNG;제한/NNG,12,20,32,0.39121810464134,Dovish
동의서/NNG,7,24,31,0.1901754675339847,Dovish
뺏기/VV,5,16,21,0.2037594295006979,Dovish
판결/NNG,48,43,91,0.727847636542028,Dovish
글로벌/NNG;금융시장/NNG;안정/NNG,6,11,17,0.3556528224012182,Dovish
절대/MAG,76,115,191,0.4309068978658238,Dovish
취업자/NNG;증가/NNG,12,11,23,0.7113056448024364,Dovish
잠재/NNG;성장/NNG,21,39,60,0.3510931708319719,Dovish
기계학습/NNG,3,17,20,0.1150641484239235,Dovish
훼손/NNG,110,111,221,0.6461560286868981,Dovish
시범/NNG,32,35,67,0.596141873739185,Dovish
비용/NNG;낮/VA,9,11,20,0.5334792336018274,Dovish
안전자산/NNG;수요/NNG;늘/VV,3,18,21,0.1086716957337055,Dovish
도산/NNG,35,37,72,0.6167853001102209,Dovish
요법/NNG,10,10,20,0.6520301744022335,Dovish
매파/NNG;통화/NNG;긴축/NNG;선호/NNG,68,64,132,0.6927820603023731,Dovish
성장/NNG;부진/NNG,8,9,17,0.5795823772464298,Dovish
곱해/VV,8,24,32,0.2173433914674112,Dovish
빨간불이/VA,22,21,43,0.6830792303261494,Dovish
비용/NNG;감소/NNG,11,10,21,0.7172331918424568,Dovish
민관/NNG,49,48,97,0.6656141363689467,Dovish
고로/NNG,3,20,23,0.097804526160335,Dovish
오성/NNG,20,25,45,0.5216241395217868,Dovish
대출/NNG;받/VV;어렵/VA,16,21,37,0.4967848947826541,Dovish
경영혁신/NNG,15,14,29,0.6986037582881073,Dovish
성장/NNG;경로/NNG;하방/NNG;위험/NNG,7,17,24,0.2684830129891549,Dovish
돌아올/VV,18,27,45,0.4346867829348222,Dovish
국민계정/NNG,13,18,31,0.4709106815127242,Dovish
영일/NNG,12,11,23,0.7113056448024364,Dovish
배제/NNG,586,515,1101,0.7419217130091433,Dovish
하위등급/NNG,85,267,352,0.2075751491542691,Dovish
비둘기/NNG,273,260,533,0.6846316831223451,Dovish
전략회의/NNG,4,46,50,0.0566982760349768,Dovish
왕복/NNG,12,17,29,0.4602565936956942,Dovish
채권/NNG;가격/NNG;오르/VV,12,24,36,0.3260150872011167,Dovish
옮겼/VV,12,12,24,0.6520301744022334,Dovish
금리/NNG;인상/NNG;멈추/VV,6,11,17,0.3556528224012182,Dovish
제1금융권/NNG,23,47,70,0.3190785959840717,Dovish
초저금리/NNG,57,75,132,0.4955429325456975,Dovish
다세대주택/NNG,34,36,70,0.6158062758243317,Dovish
경영계/NNG,11,16,27,0.4482707449015355,Dovish
기조연설/NNG,20,47,67,0.2774596486818015,Dovish
한산/NNG,20,22,42,0.5927547040020305,Dovish
휴가/NNG,32,44,76,0.4742037632016244,Dovish
저물가/NNG,40,189,229,0.1379958041062928,Dovish
지수옵션/NNG,5,13,18,0.2507808363085513,Dovish
수그러들/VV,11,10,21,0.7172331918424568,Dovish
인플레이션/NNG;전망/NNG;상향/NNG,13,13,26,0.6520301744022335,Dovish
종합지원/NNG,22,31,53,0.4627310915112624,Dovish
세이브/NNG,10,10,20,0.6520301744022335,Dovish
다가서/VV,14,19,33,0.4804432864016457,Dovish
담합/NNG,19,32,51,0.3871429160513261,Dovish
장단기/NNG,152,227,379,0.4366017026834339,Dovish
이동성/NNG,11,19,30,0.3774911536012931,Dovish
전구간/NNG,30,52,82,0.376171254462827,Dovish
피력/NNG,83,143,226,0.3784510802474501,Dovish
구조적/VAX,379,378,757,0.6537551219535622,Dovish
연구/NNG,395,416,811,0.6191151896367361,Dovish
사록/NNG,70,79,149,0.5777482557994474,Dovish
환경/NNG;안정/NNG,12,18,30,0.4346867829348222,Dovish
순유/NNG,14,27,41,0.3380897200604173,Dovish
미/NNG;금리/NNG;인상/NNG,13,16,29,0.5297745167018147,Dovish
고용/NNG;늘/VV,10,10,20,0.6520301744022335,Dovish
석화/NNG,9,10,19,0.5868271569620102,Dovish
액침/NNG,8,11,19,0.4742037632016244,Dovish
만일/MAG,83,77,160,0.7028377204595503,Dovish
보험기금/NNG,51,66,117,0.5038414984017258,Dovish
아이/NNG,256,353,609,0.4728604097647926,Dovish
투자의견없음/NNG,1,16,17,0.0407518859001395,Dovish
위험/NNG;증대/NNG,7,24,31,0.1901754675339847,Dovish
나눠서/VV,15,26,41,0.376171254462827,Dovish
차익매물/NNG,21,21,42,0.6520301744022335,Dovish
국제/NNG;유가/NNG;안정/NNG,17,16,33,0.6927820603023731,Dovish
출석/NNG,36,80,116,0.2934135784810051,Dovish
일체/NNG,6,11,17,0.3556528224012182,Dovish
승환/NNG,11,16,27,0.4482707449015355,Dovish
실업급여/NNG,4,17,21,0.1534188645652314,Dovish
상거래/NNG,8,17,25,0.3068377291304628,Dovish
수지/NNG;흑자/NNG;확대/NNG,4,14,18,0.1862943355434952,Dovish
주점/NNG,8,15,23,0.3477494263478579,Dovish
가격산정/NNG,2,24,26,0.0543358478668528,Dovish
수축국면/NNG,15,30,45,0.3260150872011167,Dovish
일드커브/NNG,300,380,680,0.5147606640017632,Dovish
일률적/VAX,24,22,46,0.7113056448024364,Dovish
매각액/NNG,11,11,22,0.6520301744022334,Dovish
스케일/NNG,69,78,147,0.576795923509668,Dovish
상저하고/NNG,24,31,55,0.5047975543759227,Dovish
잠정치/NNG,118,152,270,0.506181319601734,Dovish
연락/NNG,36,34,70,0.6903848905435414,Dovish
통안채/NNG,2493,2486,4979,0.6538661402995849,Dovish
연방/NNG,91,159,250,0.373174502330838,Dovish
교직원/NNG,20,28,48,0.4657358388587382,Dovish
의존/NNG,254,222,476,0.7460165058476005,Dovish
공조/NNG,157,187,344,0.5474264031077575,Dovish
투자/NNG;비중/NNG;확대/NNG,7,13,20,0.3510931708319719,Dovish
내실화/NNG,11,14,25,0.512309422744612,Dovish
잠시/NNG,9,8,17,0.7335339462025127,Dovish
간부/NNG,12,11,23,0.7113056448024364,Dovish
수출입은행/NNG,32,52,84,0.4012493380936822,Dovish
정확/NNG,651,744,1395,0.5705264026019543,Dovish
장단기스프레드/NNG,257,366,623,0.4578463246485628,Dovish
설비/NNG;투자/NNG;부진/NNG,16,19,35,0.5490780416018809,Dovish
출생/NNG,180,159,339,0.7381473672478115,Dovish
관세율/NNG,30,29,59,0.6745139735195519,Dovish
넓힌/VV,5,14,19,0.2328679194293691,Dovish
미/NNG;국채/NNG;금리/NNG;상승/NNG,27,34,61,0.517788667907656,Dovish
산업/NNG;호조/NNG,5,13,18,0.2507808363085513,Dovish
극도/NNG,27,51,78,0.3451924452717707,Dovish
개시/NNG,217,242,459,0.5846716853110937,Dovish
세로/NNG,71,82,153,0.5645627119824217,Dovish
사발/NNG,9,9,18,0.6520301744022334,Dovish
유언장/NNG,6,11,17,0.3556528224012182,Dovish
대손충당금/NNG;증가/NNG,3,15,18,0.1304060348804467,Dovish
주택/NNG;감소/NNG,10,9,19,0.7244779715580372,Dovish
소액/NNG,252,259,511,0.6344077372562271,Dovish
현금결제/NNG,8,44,52,0.1185509408004061,Dovish
프로그램매매/NNG,9,11,20,0.5334792336018274,Dovish
무역금융/NNG,9,24,33,0.2445113154008375,Dovish
상당히/MAG,478,492,970,0.6334764702525765,Dovish
a-등급/NNG,14,20,34,0.4564211220815634,Dovish
나타난다/VV,55,55,110,0.6520301744022335,Dovish
종금/NNG,253,326,579,0.5060234175575615,Dovish
소비/NNG;개선/NNG,12,13,25,0.6018740071405232,Dovish
소득분배/NNG,9,10,19,0.5868271569620102,Dovish
gni/NNG,4,15,19,0.1738747131739289,Dovish
금융제도/NNG,9,11,20,0.5334792336018274,Dovish
cds/NNG,655,943,1598,0.4528947658891442,Dovish
부실자산/NNG,86,75,161,0.7476612666478945,Dovish
강보합/NNG,233,258,491,0.5888489559524047,Dovish
주식수/NNG,24,30,54,0.5216241395217868,Dovish
가계/NNG;대출/NNG;증가/NNG;둔화/NNG,9,17,26,0.3451924452717707,Dovish
중간재/NNG,53,52,105,0.6645692162176611,Dovish
성장/NNG;추세/NNG,9,18,27,0.3260150872011167,Dovish
코루나/NNG,8,22,30,0.2371018816008122,Dovish
소유권/NNG,32,75,107,0.2781995410782863,Dovish
모빌/NNG,9,8,17,0.7335339462025127,Dovish
보령/NNG,8,34,42,0.1534188645652314,Dovish
대위변제/NNG,38,42,80,0.5899320625544018,Dovish
결집/NNG,27,26,53,0.6771082580330886,Dovish
불안/NNG;지정학/NNG;위험/NNG,7,11,18,0.4149282928014213,Dovish
사유/NNG,134,132,266,0.661909419468934,Dovish
패닉/NNG,21,30,51,0.4564211220815634,Dovish
낮/VA;추세/NNG,11,14,25,0.512309422744612,Dovish
사이버/NNG,27,32,59,0.5501504596518845,Dovish
드레드레/MAG,11,11,22,0.6520301744022334,Dovish
비관론자/NNG,8,10,18,0.5216241395217869,Dovish
상승률/NNG;하락/NNG,10,12,22,0.5433584786685279,Dovish
구간별/NNG,68,59,127,0.7514924043957946,Dovish
관차/NNG,7,15,22,0.3042807480543756,Dovish
정금/NNG,17,25,42,0.4433805185935188,Dovish
금리/NNG;하단/NNG,34,44,78,0.5038414984017259,Dovish
대행/NNG,69,105,174,0.4284769717500391,Dovish
주식형/NNG,309,320,629,0.6296166371571568,Dovish
골라/VV,17,17,34,0.6520301744022335,Dovish
쏠쏠/NNG,10,15,25,0.4346867829348223,Dovish
투어/NNG,28,26,54,0.7021863416639438,Dovish
더해져/VV,59,55,114,0.6994505507223959,Dovish
부과/NNG,465,418,883,0.7253445720024846,Dovish
아버지/NNG,7,24,31,0.1901754675339847,Dovish
스톡옵션/NNG,4,17,21,0.1534188645652314,Dovish
좌측/NNG,6,21,27,0.1862943355434952,Dovish
채권최고액/NNG,9,9,18,0.6520301744022334,Dovish
네고/NNG,26,25,51,0.6781113813783228,Dovish
내역/NNG,182,158,340,0.7510727325392816,Dovish
신용등급/NNG;부정적/VAX;안정/NNG,8,11,19,0.4742037632016244,Dovish
수탁자/NNG,21,35,56,0.3912181046413401,Dovish
인구구조/NNG,71,139,210,0.333051384047184,Dovish
아르바이트/NNG,21,23,44,0.5953318983672568,Dovish
시키/VV,10,9,19,0.7244779715580372,Dovish
부실여신/NNG,16,26,42,0.4012493380936822,Dovish
금융중개기능/NNG,8,24,32,0.2173433914674112,Dovish
타격/NNG;줄/VV,10,9,19,0.7244779715580372,Dovish
행정지도/NNG,25,22,47,0.740943380002538,Dovish
단기/NNG;금리/NNG;안정/NNG,5,20,25,0.1630075436005583,Dovish
모은/VV,58,77,135,0.4911396118873966,Dovish
세이빙/NNG,1,19,20,0.0343173776001175,Dovish
중도파/NNG,8,10,18,0.5216241395217869,Dovish
채권/NNG;금리/NNG;상승/NNG;압력/NNG,5,13,18,0.2507808363085513,Dovish
장기차입금/NNG,10,10,20,0.6520301744022335,Dovish
봉착/NNG,21,22,43,0.622392439202132,Dovish
영원히/MAG,9,9,18,0.6520301744022334,Dovish
과도기/NNG,6,14,20,0.2794415033152429,Dovish
등록증/NNG,3,20,23,0.097804526160335,Dovish
과매수/NNG,14,16,30,0.5705264026019543,Dovish
본관/NNG,24,27,51,0.5795823772464297,Dovish
부패/NNG,6,14,20,0.2794415033152429,Dovish
수용성/NNG,7,89,96,0.0512832721439958,Dovish
지수/NNG;견인/NNG,9,9,18,0.6520301744022334,Dovish
가계/NNG;대출/NNG;억제/NNG,20,22,42,0.5927547040020305,Dovish
기업/NNG;성장/NNG,34,32,66,0.6927820603023731,Dovish
연명/NNG,22,20,42,0.7172331918424568,Dovish
발행회사/NNG,9,21,30,0.2794415033152429,Dovish
신용/NNG;불안/NNG,5,14,19,0.2328679194293691,Dovish
무조건/NNG,10,14,24,0.4657358388587382,Dovish
모형/NNG,226,221,447,0.6667819883027364,Dovish
친숙/NNG,10,11,21,0.5927547040020305,Dovish
국채/NNG;발행/NNG;증가/NNG,8,12,20,0.4346867829348224,Dovish
문제점/NNG,63,58,121,0.7082396721955295,Dovish
역내/NNG,44,40,84,0.7172331918424568,Dovish
저축/NNG,494,457,951,0.7048203635770315,Dovish
지폐/NNG,14,46,60,0.1984439661224189,Dovish
국고채/NNG;금리/NNG;상승/NNG,20,43,63,0.3032698485591784,Dovish
은도/NNG,11,13,24,0.551717839878813,Dovish
차입/NNG;부담/NNG,10,16,26,0.4075188590013959,Dovish
구포/NNG,6,11,17,0.3556528224012182,Dovish
aaa등급/NNG,36,51,87,0.4602565936956942,Dovish
irs/NNG,965,1367,2332,0.4602846512788262,Dovish
고령화/NNG,222,239,461,0.6056514590681834,Dovish
월별/NNG,131,132,263,0.6470905518688832,Dovish
기념사/NNG,11,35,46,0.2049237690978448,Dovish
마찰/NNG,37,39,76,0.6185927295610933,Dovish
금융기관/NNG,904,1070,1974,0.5508740912706721,Dovish
니케/NNG,19,26,45,0.4764835889862476,Dovish
환급금/NNG,50,53,103,0.6151228060398429,Dovish
내수/NNG;성장/NNG,21,23,44,0.5953318983672568,Dovish
내줄/VV,17,27,44,0.410537517216221,Dovish
세션/NNG,85,159,244,0.3485695900892443,Dovish
살림살이/NNG,20,22,42,0.5927547040020305,Dovish
고액권/NNG,1,21,22,0.0310490559239158,Dovish
대항력/NNG,17,15,32,0.7389675309891979,Dovish
등판/NNG,11,11,22,0.6520301744022334,Dovish
구멍/NNG,9,12,21,0.4890226308016751,Dovish
적어도/MAG,164,148,312,0.7225199229862587,Dovish
더뎌지/VA,12,30,42,0.2608120697608934,Dovish
임금/NNG;상승률/NNG;둔화/NNG,6,11,17,0.3556528224012182,Dovish
향배/NNG,25,22,47,0.740943380002538,Dovish
그리스사태/NNG,4,48,52,0.0543358478668528,Dovish
원자재/NNG;가격/NNG;하락/NNG,12,11,23,0.7113056448024364,Dovish
글로벌/NNG,5766,5124,10890,0.7337248215463074,Dovish
고통/NNG,153,147,300,0.6786436509084471,Dovish
기울기/NNG,20,18,38,0.7244779715580372,Dovish
융기/NNG,6,12,18,0.3260150872011167,Dovish
역점/NNG,20,21,41,0.6209811184783176,Dovish
목표제/NNG,8,20,28,0.2608120697608934,Dovish
탄도미사일/NNG,13,16,29,0.5297745167018147,Dovish
원스톱/NNG,57,52,109,0.7147253834793713,Dovish
시위/NNG,14,39,53,0.2340621138879812,Dovish
상하/NNG,18,48,66,0.2445113154008375,Dovish
프랑스국채/NNG,6,24,30,0.1630075436005583,Dovish
실력/NNG,10,12,22,0.5433584786685279,Dovish
국제/NNG;금융시장/NNG;변동성/NNG;확대/NNG,4,15,19,0.1738747131739289,Dovish
발명/NNG,7,17,24,0.2684830129891549,Dovish
불안/NNG;위험/NNG,9,10,19,0.5868271569620102,Dovish
세율/NNG,143,131,274,0.7117581293093084,Dovish
평가사/NNG,17,19,36,0.5833954192019984,Dovish
토론자/NNG,13,12,25,0.7063660222690863,Dovish
외화증권투자/NNG,3,52,55,0.0376171254462827,Dovish
이론/NNG,111,159,270,0.4551908764694837,Dovish
대중교통/NNG,22,36,58,0.3984628843569204,Dovish
모기지/NNG,398,385,783,0.6740467776937374,Dovish
총합/NNG,6,11,17,0.3556528224012182,Dovish
가계/NNG;부채/NNG;증가/NNG;확대/NNG,16,25,41,0.4172993116174294,Dovish
수소연료전지/NNG,9,9,18,0.6520301744022334,Dovish
발품/NNG,8,9,17,0.5795823772464298,Dovish
금리/NNG;변동/NNG;위험/NNG,10,31,41,0.2103323143233011,Dovish
통화정책/NNG;제약/NNG,9,9,18,0.6520301744022334,Dovish
회복/NNG;높/VA,7,13,20,0.3510931708319719,Dovish
강달러/NNG;압력/NNG,12,13,25,0.6018740071405232,Dovish
목록/NNG,16,28,44,0.3725886710869905,Dovish
국인/NNG,22,24,46,0.5976943265353807,Dovish
맞춰질/VV,6,17,23,0.2301282968478471,Dovish
외국인/NNG;자금/NNG;이탈/NNG,31,28,59,0.7218905502310442,Dovish
짓누르/VV,18,17,35,0.6903848905435414,Dovish
절박/NNG,9,8,17,0.7335339462025127,Dovish
정형/NNG,30,36,66,0.5433584786685278,Dovish
연말효과/NNG,20,36,56,0.3622389857790186,Dovish
고령/NNG,178,158,336,0.7345656395164403,Dovish
세이렌/NNG,1,24,25,0.0271679239334264,Dovish
차주/NNG;부담/NNG,10,10,20,0.6520301744022335,Dovish
경색/NNG,118,157,275,0.4900608954105959,Dovish
삼노/NNG,7,15,22,0.3042807480543756,Dovish
머지않/VA,17,26,43,0.4263274217245373,Dovish
기부채납/NNG,14,19,33,0.4804432864016457,Dovish
현물시장/NNG,29,53,82,0.3567712275031089,Dovish
발행물/NNG,59,110,169,0.3497252753611979,Dovish
평민/NNG,49,61,110,0.5237619433722859,Dovish
법정/NNG,114,127,241,0.5852869282035796,Dovish
진구/NNG,6,13,19,0.3009370035702616,Dovish
니스/NNG,22,23,45,0.623681036384745,Dovish
가닥/NNG,17,18,35,0.6158062758243317,Dovish
사퇴/NNG,9,11,20,0.5334792336018274,Dovish
가계/NNG;이자/NNG;부담/NNG;경감/NNG,15,20,35,0.4890226308016751,Dovish
루트/NNG,6,11,17,0.3556528224012182,Dovish
재대출/NNG,4,22,26,0.1185509408004061,Dovish
외부감사/NNG,7,18,25,0.253567290045313,Dovish
제3자/NNG,98,99,197,0.6454440110244332,Dovish
외수/NNG,3,17,20,0.1150641484239235,Dovish
매매동향/NNG,40,47,87,0.554919297363603,Dovish
명명/NNG,9,18,27,0.3260150872011167,Dovish
그렉시트/NNG,4,21,25,0.1241962236956635,Dovish
공정가격/NNG,18,44,62,0.2667396168009137,Dovish
변동금리부/NNG,9,21,30,0.2794415033152429,Dovish
동네/NNG,39,35,74,0.7265479086196317,Dovish
덧붙여/VV,8,14,22,0.3725886710869905,Dovish
고용증감/NNG,42,53,95,0.5167031570734681,Dovish
아제/NNG,1,21,22,0.0310490559239158,Dovish
경제/NNG;성장률/NNG;하락/NNG,9,10,19,0.5868271569620102,Dovish
주택/NNG;공급/NNG;확대/NNG,25,28,53,0.5821697985734228,Dovish
동일/NNG,624,542,1166,0.750676805953863,Dovish
화곡/NNG,9,11,20,0.5334792336018274,Dovish
전영역/NNG,10,11,21,0.5927547040020305,Dovish
들어와서/VV,6,16,22,0.2445113154008375,Dovish
손잡/VV,26,24,50,0.7063660222690863,Dovish
인생/NNG,22,29,51,0.4946435805810047,Dovish
우양/NNG,7,15,22,0.3042807480543756,Dovish
비시/NNG,4,13,17,0.2006246690468411,Dovish
명단/NNG,18,18,36,0.6520301744022334,Dovish
누그러질/VV,9,8,17,0.7335339462025127,Dovish
존재/NNG,474,424,898,0.7289205251572138,Dovish
소셜/NNG,16,15,31,0.6954988526957158,Dovish
유동화/NNG,368,364,732,0.6591953411539064,Dovish
묶여/VV,52,48,100,0.7063660222690863,Dovish
양방향/NNG;위험/NNG,1,22,23,0.0296377352001015,Dovish
형사/NNG,28,26,54,0.7021863416639438,Dovish
응모/NNG,30,29,59,0.6745139735195519,Dovish
시장구조/NNG,9,13,22,0.4514055053553924,Dovish
안정성/NNG;개선/NNG,4,28,32,0.0931471677717476,Dovish
찬반/NNG,17,16,33,0.6927820603023731,Dovish
악용/NNG,8,13,21,0.4012493380936822,Dovish
대출/NNG;금리/NNG;상승/NNG,23,26,49,0.5767959235096681,Dovish
소외주/NNG,8,11,19,0.4742037632016244,Dovish
팩트/NNG,15,13,28,0.752342508925654,Dovish
서로/MAG,113,98,211,0.7518307113005346,Dovish
대출심사/NNG,57,57,114,0.6520301744022334,Dovish
약식/NNG,26,32,58,0.5297745167018147,Dovish
채권지수/NNG,138,208,346,0.432596942632251,Dovish
정당/NNG,171,193,364,0.5777054913097509,Dovish
cp/NNG,495,535,1030,0.6032802548207581,Dovish
국민주택/NNG,16,28,44,0.3725886710869905,Dovish
명시적/VAX,18,16,34,0.7335339462025127,Dovish
한식/NNG,9,17,26,0.3451924452717707,Dovish
조작/NNG,40,42,82,0.6209811184783176,Dovish
택할/VV,9,11,20,0.5334792336018274,Dovish
신청액/NNG,9,23,32,0.2551422421573957,Dovish
금정/NNG,6,12,18,0.3260150872011167,Dovish
은행/NNG;부담/NNG,9,8,17,0.7335339462025127,Dovish
컨퍼런스/NNG,144,237,381,0.3961702325481925,Dovish
수출/NNG;경쟁력/NNG;강화/NNG,9,23,32,0.2551422421573957,Dovish
트리거/NNG,65,114,179,0.3717715906679402,Dovish
중장기물/NNG,59,101,160,0.3808889137597205,Dovish
타국/NNG,8,17,25,0.3068377291304628,Dovish
정전/NNG,9,12,21,0.4890226308016751,Dovish
인플레이션/NNG;압력/NNG,51,46,97,0.7229030194459545,Dovish
安定/NNG,12,18,30,0.4346867829348222,Dovish
남중/NNG,13,24,37,0.3531830111345431,Dovish
차주/NNG;이자/NNG;부담/NNG,10,17,27,0.3835471614130785,Dovish
소명/NNG,13,13,26,0.6520301744022335,Dovish
풍성/NNG,9,16,25,0.3667669731012563,Dovish
손꼽힌다/VV,20,18,38,0.7244779715580372,Dovish
하락/NNG;위험/NNG,14,21,35,0.4346867829348223,Dovish
감사의견/NNG,4,14,18,0.1862943355434952,Dovish
석방/NNG,5,13,18,0.2507808363085513,Dovish
개방경제/NNG,14,34,48,0.2684830129891549,Dovish
지원금액/NNG,9,11,20,0.5334792336018274,Dovish
공모발행/NNG,13,26,39,0.3260150872011167,Dovish
상향/NNG;안정/NNG,8,9,17,0.5795823772464298,Dovish
그레/NNG,1,32,33,0.0203759429500697,Dovish
빌라/NNG,318,353,671,0.5873812902547033,Dovish
사분면/NNG,1,17,18,0.0383547161413078,Dovish
잔류/NNG,10,32,42,0.2037594295006979,Dovish
중도환매/NNG,41,163,204,0.1640075898803163,Dovish
국채시장/NNG,79,153,232,0.3366691750181467,Dovish
악순환/NNG;빠지/VV,10,9,19,0.7244779715580372,Dovish
금리/NNG;소폭/MAG;상승/NNG,35,42,77,0.5433584786685279,Dovish
중소기업진흥공단/NNG,11,14,25,0.512309422744612,Dovish
전분/NNG,7,11,18,0.4149282928014213,Dovish
스펙/NNG,12,15,27,0.5216241395217868,Dovish
리라/NNG,52,76,128,0.4461259088015282,Dovish
실적/NNG;전망/NNG;상향/NNG,5,23,28,0.141745690087442,Dovish
세제개편/NNG,41,43,84,0.6217031895463156,Dovish
처하/VV,17,19,36,0.5833954192019984,Dovish
훌륭/NNG,20,23,43,0.5669827603497682,Dovish
꼬마/NNG,23,24,47,0.6248622504688072,Dovish
명동/NNG,14,13,27,0.7021863416639438,Dovish
의사/NNG,145,153,298,0.6179370933877376,Dovish
청약금액/NNG,19,24,43,0.5161905547351016,Dovish
완화정책/NNG,179,286,465,0.4080888154475517,Dovish
국고채/NNG;상승/NNG,11,20,31,0.3586165959212284,Dovish
매수강도/NNG,11,17,28,0.4219018775543863,Dovish
신용등급/NNG,1336,1277,2613,0.6821552960073484,Dovish
아카데미/NNG,24,29,53,0.5396111788156415,Dovish
재정/NNG;긴축/NNG,6,16,22,0.2445113154008375,Dovish
건전성/NNG;관리/NNG;강화/NNG,15,13,28,0.752342508925654,Dovish
외국환은행/NNG,9,44,53,0.1333698084004568,Dovish
채여/VV,17,28,45,0.3958754630299275,Dovish
양육/NNG,14,15,29,0.6085614961087512,Dovish
가집행/NNG,7,15,22,0.3042807480543756,Dovish
휴장/NNG,108,123,231,0.5725142994751319,Dovish
국채/NNG;금리/NNG;급등/NNG,56,67,123,0.5449804442764936,Dovish
전망/NNG;인하/NNG,14,25,39,0.3651368976652507,Dovish
내각/NNG,16,24,40,0.4346867829348224,Dovish
순유입/NNG,392,493,885,0.5184499561169889,Dovish
간접/NNG,94,84,178,0.7296528142120232,Dovish
適應/NNG,1,26,27,0.0250780836308551,Dovish
준다는/VV,14,17,31,0.5369660259783099,Dovish
금리/NNG;물가/NNG;안정/NNG,4,25,29,0.1043248279043573,Dovish
대체/MAG,47,45,92,0.681009293264555,Dovish
부동산/NNG;경기/NNG;둔화/NNG,13,22,35,0.3852905576013198,Dovish
협상력/NNG,26,30,56,0.565092817815269,Dovish
도시개발공사/NNG,9,37,46,0.1586019343140568,Dovish
표기/NNG,16,20,36,0.5216241395217869,Dovish
피드백/NNG,9,8,17,0.7335339462025127,Dovish
종합소득세/NNG,14,13,27,0.7021863416639438,Dovish
위험/NNG;우려/NNG,12,11,23,0.7113056448024364,Dovish
평균액/NNG,6,11,17,0.3556528224012182,Dovish
내외/NNG;금리갭/NNG;축소/NNG,4,14,18,0.1862943355434952,Dovish
실체/NNG,41,37,78,0.7225199229862587,Dovish
aa-등급/NNG,25,50,75,0.3260150872011167,Dovish
저인플레이션/NNG,7,16,23,0.2852632013009771,Dovish
가격/NNG;갭/NNG;확대/NNG,6,11,17,0.3556528224012182,Dovish
연작/NNG,3,18,21,0.1086716957337055,Dovish
주택담보대출/NNG;금리/NNG;하락/NNG,31,27,58,0.7486272372766384,Dovish
스토어/NNG,25,47,72,0.3468245608522518,Dovish
경기민감물가/NNG,6,23,29,0.1700948281049304,Dovish
고용/NNG;지표/NNG;개선/NNG,10,16,26,0.4075188590013959,Dovish
공덕/NNG,10,10,20,0.6520301744022335,Dovish
부별/NNG,14,13,27,0.7021863416639438,Dovish
골든/NNG,11,19,30,0.3774911536012931,Dovish
호주달러/NNG,59,87,146,0.4421813826405951,Dovish
물가/NNG;상승/NNG;압력/NNG;높/VA,9,8,17,0.7335339462025127,Dovish
발행계획/NNG,98,85,183,0.751752436369634,Dovish
납입/NNG,252,394,646,0.417034527790261,Dovish
과민/NNG,7,11,18,0.4149282928014213,Dovish
섣불/VA,45,42,87,0.6986037582881074,Dovish
괴리율/NNG,10,12,22,0.5433584786685279,Dovish
담대/NNG,53,57,110,0.6062736709354101,Dovish
관광객수/NNG,12,24,36,0.3260150872011167,Dovish
정치/NNG;불안/NNG,6,24,30,0.1630075436005583,Dovish
잔존만기/NNG,209,307,516,0.4438902490230189,Dovish
코픽스/NNG;오르/VV,22,23,45,0.623681036384745,Dovish
이수/NNG,38,41,79,0.6043206494459725,Dovish
수혜자/NNG,18,19,37,0.617712796802116,Dovish
임직원수/NNG,3,14,17,0.1397207516576214,Dovish
글로벌본드/NNG,12,18,30,0.4346867829348222,Dovish
단리/NNG,13,21,34,0.4036377270109064,Dovish
무한/NNG,10,35,45,0.1862943355434953,Dovish
근처/NNG,50,55,105,0.5927547040020305,Dovish
렌트/NNG,13,19,32,0.4461259088015282,Dovish
외화증권/NNG,18,18,36,0.6520301744022334,Dovish
자산배분전략/NNG,16,68,84,0.1534188645652314,Dovish
증빙/NNG,504,559,1063,0.5878769372070226,Dovish
공휴일/NNG,42,42,84,0.6520301744022335,Dovish
금융안정/NNG,344,459,803,0.4886674945411075,Dovish
홍콩h주/NNG,77,80,157,0.6275790428621497,Dovish
신용등급/NNG;하향/NNG,33,43,76,0.5003952501226443,Dovish
관찰대상국/NNG,9,12,21,0.4890226308016751,Dovish
능가/NNG,18,17,35,0.6903848905435414,Dovish
문구/NNG,207,237,444,0.5694947092880268,Dovish
혼동/NNG,9,8,17,0.7335339462025127,Dovish
시티/NNG,199,173,372,0.7500231485898524,Dovish
개혁/NNG,285,302,587,0.6153264890882004,Dovish
신용/NNG;회복/NNG,14,31,45,0.2944652400526216,Dovish
주택가격/NNG;오르/VV,8,12,20,0.4346867829348224,Dovish
목적/NNG,1029,1014,2043,0.6616755911833316,Dovish
제작/NNG,330,323,653,0.6661608592963995,Dovish
조이/VV,19,20,39,0.6194286656821218,Dovish
지지자/NNG,8,20,28,0.2608120697608934,Dovish
스티프닝/NNG,73,87,160,0.5471057785214144,Dovish
갈아탔/VV,9,19,28,0.308856398401058,Dovish
재정절벽/NNG,2,53,55,0.0246049122415937,Dovish
학술/NNG,20,49,69,0.2661347650621361,Dovish
경제/NNG;충격/NNG,11,17,28,0.4219018775543863,Dovish
역동/NNG,76,95,171,0.5216241395217868,Dovish
여신/NNG,690,680,1370,0.6616188534375604,Dovish
테일러준칙/NNG,24,33,57,0.4742037632016243,Dovish
분납/NNG,13,15,28,0.565092817815269,Dovish
기타금융기관/NNG,15,33,48,0.2963773520010151,Dovish
지주회사/NNG,110,100,210,0.7172331918424568,Dovish
증감액/NNG,10,30,40,0.2173433914674111,Dovish
줄어든다는/VV,13,13,26,0.6520301744022335,Dovish
통화/NNG;안정/NNG,8,14,22,0.3725886710869905,Dovish
은과/NNG,12,11,23,0.7113056448024364,Dovish
순천/NNG,18,28,46,0.4191622549728643,Dovish
간다는/VV,9,9,18,0.6520301744022334,Dovish
원리금/NNG;상환/NNG;부담/NNG;늘/VV,3,14,17,0.1397207516576214,Dovish
기물/NNG,10,15,25,0.4346867829348223,Dovish
m&a/NNG,153,146,299,0.6832918950927516,Dovish
싱에/NNG,11,19,30,0.3774911536012931,Dovish
총요소생산성/NNG,10,10,20,0.6520301744022335,Dovish
가릴/VV,9,9,18,0.6520301744022334,Dovish
매파/NNG;비둘기/NNG,7,13,20,0.3510931708319719,Dovish
시장상황점검회의/NNG,41,38,79,0.7035062408024099,Dovish
上昇/NNG,11,13,24,0.551717839878813,Dovish
팬덤/NNG,8,26,34,0.2006246690468411,Dovish
등재/NNG,25,34,59,0.4794339517663482,Dovish
에테/NNG,9,9,18,0.6520301744022334,Dovish
시일/NNG,86,79,165,0.7098049999821783,Dovish
가계/NNG;소득/NNG;감소/NNG,5,19,24,0.1715868880005877,Dovish
해산/NNG,12,13,25,0.6018740071405232,Dovish
가계/NNG;부채/NNG;원리금/NNG;상환/NNG;부담/NNG,3,20,23,0.097804526160335,Dovish
상담소/NNG,8,13,21,0.4012493380936822,Dovish
판매대/NNG,3,15,18,0.1304060348804467,Dovish
임명/NNG,34,43,77,0.5155587425506033,Dovish
가계/NNG;소득/NNG;부진/NNG,3,18,21,0.1086716957337055,Dovish
심리/NNG;살/VV,12,12,24,0.6520301744022334,Dovish
상한/VV,12,16,28,0.4890226308016751,Dovish
크레딧/NNG;시장/NNG;강세/NNG,10,19,29,0.3431737760011755,Dovish
지표채권/NNG,6,18,24,0.2173433914674111,Dovish
담회/NNG,32,28,60,0.7451773421739811,Dovish
상점/NNG,10,13,23,0.5015616726171027,Dovish
침체국면/NNG,119,109,228,0.7118494564574843,Dovish
정치/NNG;위험/NNG,14,23,37,0.3968879322448378,Dovish
경기/NNG;진작/NNG,6,12,18,0.3260150872011167,Dovish
보호주의/NNG,10,12,22,0.5433584786685279,Dovish
파급효과/NNG,71,137,208,0.3379134480478728,Dovish
법률안/NNG,12,17,29,0.4602565936956942,Dovish
원리금/NNG;상환/NNG;부담/NNG,11,45,56,0.1593851537427681,Dovish
수출/NNG;제한/NNG,9,11,20,0.5334792336018274,Dovish
이상거래/NNG,60,70,130,0.5588830066304858,Dovish
놀라움/NNG,6,13,19,0.3009370035702616,Dovish
국민소득/NNG,23,28,51,0.5355962146875489,Dovish
업황/NNG;부진/NNG,48,42,90,0.745177342173981,Dovish
기와/NNG,6,13,19,0.3009370035702616,Dovish
계부/NNG,11,13,24,0.551717839878813,Dovish
발행어음/NNG,59,61,120,0.6306521358972422,Dovish
직구/NNG,18,62,80,0.189299082890971,Dovish
얽혀/VV,13,26,39,0.3260150872011167,Dovish
엿보/VV,11,11,22,0.6520301744022334,Dovish
시들/NNG,15,13,28,0.752342508925654,Dovish
마이너스갭/NNG,7,11,18,0.4149282928014213,Dovish
무제한/NNG,23,43,66,0.3487603258430551,Dovish
포용/NNG,133,152,285,0.5705264026019543,Dovish
정말로/MAG,15,13,28,0.752342508925654,Dovish
과소/NNG,42,47,89,0.5826652622317832,Dovish
카드사태/NNG,14,44,58,0.2074641464007106,Dovish
신규/NNG;투자/NNG;확대/NNG,3,19,22,0.1029521328003526,Dovish
상금/NNG,26,80,106,0.2119098066807259,Dovish
상호/NNG,173,217,390,0.5198212911133014,Dovish
순발행/NNG,638,843,1481,0.493470048954478,Dovish
인플레이션/NNG;완화/NNG,49,57,106,0.5605171674685867,Dovish
특검법/NNG,9,30,39,0.19560905232067,Dovish
주택/NNG;전세가격/NNG;상승/NNG,8,15,23,0.3477494263478579,Dovish
부동산/NNG;안정/NNG,14,21,35,0.4346867829348223,Dovish
외화자금/NNG,130,116,246,0.730723471312848,Dovish
부를/VV,33,38,71,0.5662367304019397,Dovish
표면/NNG,62,73,135,0.5537790522320339,Dovish
주제/NNG,324,310,634,0.6814766984074957,Dovish
한우/NNG,8,27,35,0.1931941257488099,Dovish
s&p/NNG,101,180,281,0.3658613756368087,Dovish
매매수수료/NNG,15,15,30,0.6520301744022334,Dovish
현금자산/NNG,8,10,18,0.5216241395217869,Dovish
나타/NNG,19,18,37,0.6882540729801354,Dovish
제치/NNG,126,166,292,0.4949144697269965,Dovish
산업/NNG;성장/NNG,25,30,55,0.5433584786685278,Dovish
가시권/NNG,12,20,32,0.39121810464134,Dovish
분할상환대출/NNG,7,34,41,0.1342415064945774,Dovish
증산/NNG,36,31,67,0.757196331563884,Dovish
쏠림/NNG,253,242,495,0.681667909602335,Dovish
러브/NNG,15,17,32,0.5753207421196178,Dovish
개개인/NNG,9,8,17,0.7335339462025127,Dovish
주관사/NNG,100,89,189,0.7326181734856556,Dovish
높/VA;안정/NNG,10,13,23,0.5015616726171027,Dovish
주지/NNG,62,83,145,0.4870586844932346,Dovish
연정/NNG,31,38,69,0.5319193528018221,Dovish
표시/NNG,407,432,839,0.614296946716919,Dovish
메커니즘/NNG,30,40,70,0.4890226308016751,Dovish
기본급/NNG,8,12,20,0.4346867829348224,Dovish
통화신용정책/NNG,19,31,50,0.3996313972142721,Dovish
드레드/NNG,11,11,22,0.6520301744022334,Dovish
철회/NNG,140,384,524,0.2377193344174809,Dovish
위탁자/NNG,8,10,18,0.5216241395217869,Dovish
외화환산이익/NNG,2,24,26,0.0543358478668528,Dovish
경제/NNG;강하/VA,9,8,17,0.7335339462025127,Dovish
신흥국/NNG,954,1598,2552,0.3892595659447627,Dovish
내포/NNG,27,33,60,0.5334792336018274,Dovish
형성/NNG,727,638,1365,0.7429873617404761,Dovish
매입액/NNG,56,85,141,0.4295728207826479,Dovish
기울여/VV,12,46,58,0.1700948281049304,Dovish
파급경로/NNG,19,56,75,0.2212245234579006,Dovish
심리/NNG;확산/NNG,10,10,20,0.6520301744022335,Dovish
대미/NNG,79,72,151,0.7154219969135617,Dovish
부도난/VV,10,10,20,0.6520301744022335,Dovish
얼마/NNG,171,155,326,0.71933651498569,Dovish
고사/NNG,9,12,21,0.4890226308016751,Dovish
소비/NNG;심리/NNG;개선/NNG,9,9,18,0.6520301744022334,Dovish
정책조합/NNG,7,25,32,0.1825684488326253,Dovish
금리/NNG;인하/NNG;기대/NNG;약화/NNG,55,48,103,0.747117908169226,Dovish
양립/NNG,12,22,34,0.3556528224012182,Dovish
일반기업/NNG,37,33,70,0.7310641349358376,Dovish
동향/NNG,1520,1491,3011,0.6647121831598892,Dovish
인하/NNG;조치/NNG;종료/NNG,11,12,23,0.5976943265353807,Dovish
장기전세주택/NNG,24,100,124,0.156487241856536,Dovish
금융부채/NNG,28,57,85,0.3202955242677638,Dovish
보성/NNG,8,9,17,0.5795823772464298,Dovish
투자설명회/NNG,36,33,69,0.7113056448024365,Dovish
갭투자/NNG,89,84,173,0.6908414943071283,Dovish
복병/NNG,32,30,62,0.6954988526957158,Dovish
부실기업/NNG,15,27,42,0.3622389857790185,Dovish
주거비/NNG;부담/NNG,10,9,19,0.7244779715580372,Dovish
집중도/NNG,12,39,51,0.200624669046841,Dovish
미/NNG;금리/NNG;상승/NNG,25,23,48,0.7087284504372103,Dovish
획기/NNG,16,15,31,0.6954988526957158,Dovish
위함/VV,33,29,62,0.741965370871507,Dovish
닥터/NNG,8,16,24,0.3260150872011167,Dovish
잠재/NNG,640,786,1426,0.530915154729554,Dovish
이마/NNG,9,11,20,0.5334792336018274,Dovish
향상/NNG,237,204,441,0.7575056437908301,Dovish
기간스프레드/NNG,73,73,146,0.6520301744022335,Dovish
부정적/VAX,1197,1033,2230,0.7555470655948436,Dovish
이자/NNG;부담/NNG;덜/VV,4,29,33,0.0899351964692736,Dovish
거절/NNG,48,51,99,0.6136754582609256,Dovish
광안/NNG,9,11,20,0.5334792336018274,Dovish
bps/NNG,38,50,88,0.4955429325456975,Dovish
이력효과/NNG,3,14,17,0.1397207516576214,Dovish
선택권/NNG,30,48,78,0.4075188590013959,Dovish
상관없/VA,8,11,19,0.4742037632016244,Dovish
연도/NNG,107,106,213,0.6581814024626319,Dovish
자본흐름/NNG,9,16,25,0.3667669731012563,Dovish
사랑/NNG,81,82,163,0.6440785869095232,Dovish
인플레이션/NNG;위험/NNG,15,13,28,0.752342508925654,Dovish
신용위험/NNG;확대/NNG,16,20,36,0.5216241395217869,Dovish
치명/NNG,19,19,38,0.6520301744022335,Dovish
금리/NNG;상승/NNG;부담/NNG,18,22,40,0.5334792336018274,Dovish
수요/NNG;강세/NNG,9,16,25,0.3667669731012563,Dovish
팽배/NNG,35,37,72,0.6167853001102209,Dovish
입양/NNG,16,21,37,0.4967848947826541,Dovish
인니/NNG,46,64,110,0.4686466878516053,Dovish
기공식/NNG,9,9,18,0.6520301744022334,Dovish
모수/NNG,18,19,37,0.617712796802116,Dovish
평가이익/NNG,52,57,109,0.5948345450687043,Dovish
사면/NNG,53,71,124,0.4867267499058926,Dovish
달러비중/NNG,2,21,23,0.0620981118478317,Dovish
상하방/NNG,31,44,75,0.4593848956015736,Dovish
직군/NNG,4,24,28,0.1086716957337056,Dovish
장려/NNG,38,46,84,0.5386336223322798,Dovish
감축/NNG,199,195,394,0.6654051523386896,Dovish
깜짝/MAG;금리/NNG;인하/NNG,6,11,17,0.3556528224012182,Dovish
사후/NNG,38,40,78,0.6194286656821218,Dovish
수신/NNG,542,484,1026,0.7301660217479558,Dovish
준내구재/NNG,15,16,31,0.6112782885020939,Dovish
자본비율/NNG,251,260,511,0.6294598991344638,Dovish
비록/MAG,73,87,160,0.5471057785214144,Dovish
보유종목/NNG,10,13,23,0.5015616726171027,Dovish
참석자/NNG,67,85,152,0.5139531962935252,Dovish
레이트/NNG,12,25,37,0.312974483713072,Dovish
실업률/NNG;하락/NNG,18,25,43,0.4694617255696081,Dovish
은행/NNG;금리/NNG;인하/NNG,15,14,29,0.6986037582881073,Dovish
금리/NNG;인하/NNG;아니/VCN,12,14,26,0.5588830066304858,Dovish
고래/NNG,14,21,35,0.4346867829348223,Dovish
투자/NNG;선호/NNG,11,20,31,0.3586165959212284,Dovish
지출/NNG;축소/NNG,8,9,17,0.5795823772464298,Dovish
로비/NNG,11,12,23,0.5976943265353807,Dovish
노려/VV,12,12,24,0.6520301744022334,Dovish
지난번/NNG,30,31,61,0.6309969429699034,Dovish
경기/NNG;안정/NNG,8,9,17,0.5795823772464298,Dovish
업종비중/NNG,4,15,19,0.1738747131739289,Dovish
수시로/MAG,54,49,103,0.7185638656677675,Dovish
금리/NNG;상승/NNG;확대/NNG,8,16,24,0.3260150872011167,Dovish
채권비중/NNG,35,34,69,0.6712075324728874,Dovish
재간접/NNG,14,17,31,0.5369660259783099,Dovish
액수/NNG,71,70,141,0.6613448911794083,Dovish
자본증권/NNG,44,67,111,0.4281989205029592,Dovish
금리/NNG;긴축/NNG,7,11,18,0.4149282928014213,Dovish
보완/NNG,210,193,403,0.7094628840646063,Dovish
미달/NNG,104,109,213,0.6221205333746082,Dovish
자진/NNG,16,16,32,0.6520301744022335,Dovish
수출/NNG;둔화/NNG,25,25,50,0.6520301744022334,Dovish
삼겹살/NNG,15,25,40,0.39121810464134,Dovish
비우량/NNG,92,131,223,0.4579143209542403,Dovish
수량/NNG,169,227,396,0.4854321562730285,Dovish
금융중개지원대출/NNG,10,45,55,0.1448955943116074,Dovish
수자원공사/NNG,8,19,27,0.2745390208009404,Dovish
증감/NNG,152,217,369,0.4567215968163111,Dovish
적색/NNG,8,10,18,0.5216241395217869,Dovish
공식화/NNG,32,53,85,0.3936785958654994,Dovish
개화/NNG,9,10,19,0.5868271569620102,Dovish
변동금리형/NNG,29,26,55,0.727264425294799,Dovish
멀티/NNG,36,35,71,0.6706596079565831,Dovish
기본형/NNG,25,22,47,0.740943380002538,Dovish
공공자금/NNG,6,12,18,0.3260150872011167,Dovish
한남/NNG,89,92,181,0.6307683208891172,Dovish
고유/NNG,50,61,111,0.5344509626247815,Dovish
우파/NNG,13,22,35,0.3852905576013198,Dovish
항구/NNG,9,16,25,0.3667669731012563,Dovish
사연/NNG,25,27,52,0.6037316429650309,Dovish
유암/NNG,18,17,35,0.6903848905435414,Dovish
시장조성/NNG,5,20,25,0.1630075436005583,Dovish
위험/NNG;회피/NNG;확산/NNG,10,23,33,0.2834913801748841,Dovish
면밀히/MAG,329,343,672,0.62541669789602,Dovish
소득분위/NNG,10,12,22,0.5433584786685279,Dovish
회귀/NNG,58,79,137,0.4787056976623993,Dovish
통찰/NNG,10,17,27,0.3835471614130785,Dovish
구분/NNG,494,553,1047,0.5824645680916878,Dovish
가계/NNG;부채/NNG;급증/NNG,9,8,17,0.7335339462025127,Dovish
편입비/NNG,1,16,17,0.0407518859001395,Dovish
가설/NNG,11,13,24,0.551717839878813,Dovish
토크/NNG,13,27,40,0.3139404543418161,Dovish
캐쉬백/NNG,171,150,321,0.7433143988185462,Dovish
감추/VV,17,19,36,0.5833954192019984,Dovish
전파/NNG,9,24,33,0.2445113154008375,Dovish
단체/NNG,134,121,255,0.722083003057019,Dovish
목표금액/NNG,9,54,63,0.1086716957337055,Dovish
알리오/NNG,7,10,17,0.4564211220815634,Dovish
상환자금/NNG,9,14,23,0.4191622549728643,Dovish
합계/NNG,341,429,770,0.5182803950376728,Dovish
통화정책/NNG,4129,3598,7727,0.7482580850769378,Dovish
지출/NNG;증가/NNG,28,30,58,0.6085614961087512,Dovish
안정화/NNG;추세/NNG,10,12,22,0.5433584786685279,Dovish
가져오/VV,109,103,212,0.6900125146586743,Dovish
옮겨갈/VV,15,14,29,0.6986037582881073,Dovish
경제구조/NNG,52,52,104,0.6520301744022335,Dovish
소파/NNG,7,19,26,0.2402216432008228,Dovish
친구/NNG,65,68,133,0.6232641372962526,Dovish
법인/NNG,667,577,1244,0.7537333211894103,Dovish
금리/NNG;급등/NNG,83,79,162,0.6850443604479162,Dovish
인상/NNG;효과/NNG,21,20,41,0.6846316831223452,Dovish
인류/NNG,15,16,31,0.6112782885020939,Dovish
물량/NNG;부담/NNG,6,21,27,0.1862943355434952,Dovish
보안법/NNG,10,21,31,0.3104905592391588,Dovish
경제/NNG;지표/NNG;상승/NNG,8,9,17,0.5795823772464298,Dovish
유해/NNG,9,9,18,0.6520301744022334,Dovish
떠받치/VV,23,24,47,0.6248622504688072,Dovish
중립/NNG,559,1530,2089,0.2382254035887898,Dovish
공유/NNG,245,212,457,0.7535254373988076,Dovish
회복/NNG;전환/NNG,10,10,20,0.6520301744022335,Dovish
어차피/MAG,23,28,51,0.5355962146875489,Dovish
전향/NNG,20,19,39,0.6863475520023511,Dovish
높/VA;위험/NNG,8,9,17,0.5795823772464298,Dovish
안전자산/NNG;선호/NNG,85,78,163,0.7105457028742288,Dovish
거래비중/NNG,132,114,246,0.7549823072025862,Dovish
자꾸/MAG,17,18,35,0.6158062758243317,Dovish
아빠/NNG,15,13,28,0.752342508925654,Dovish
하락/NNG;멈추/VV,17,21,38,0.52783395070657,Dovish
섬세/NNG,4,21,25,0.1241962236956635,Dovish
본유/NNG,4,30,34,0.0869373565869644,Dovish
주택/NNG;경기/NNG;부진/NNG,10,11,21,0.5927547040020305,Dovish
투자유의/NNG,2,18,20,0.0724477971558037,Dovish
마라톤/NNG,9,28,37,0.2095811274864321,Dovish
연고점/NNG,119,192,311,0.4041228685097176,Dovish
골조/NNG,7,10,17,0.4564211220815634,Dovish
개선/NNG;강하/VA,2,15,17,0.0869373565869644,Dovish
인하/NNG;축소/NNG,22,30,52,0.4781554612283045,Dovish
전업사/NNG,8,13,21,0.4012493380936822,Dovish
만기수익률/NNG,95,138,233,0.4488613519435665,Dovish
가용/NNG,34,55,89,0.4030731987213807,Dovish
당첨/NNG,65,92,157,0.4606734927841867,Dovish
권위/NNG,7,13,20,0.3510931708319719,Dovish
매개/NNG,9,20,29,0.2934135784810051,Dovish
성장/NNG;회복/NNG,15,31,46,0.3154984714849517,Dovish
미/NNG;국채/NNG;금리/NNG;급등/NNG,22,25,47,0.5737865534739655,Dovish
우월/NNG,16,14,30,0.7451773421739811,Dovish
총부채/NNG,130,147,277,0.5766253243012949,Dovish
수출/NNG;실적/NNG;개선/NNG,13,23,36,0.3685387942273494,Dovish
많/VA;증가/NNG,6,14,20,0.2794415033152429,Dovish
접하/VV,8,9,17,0.5795823772464298,Dovish
채권/NNG;금리/NNG;하락/NNG,43,40,83,0.7009324374824011,Dovish
함수/NNG,7,25,32,0.1825684488326253,Dovish
주택연금/NNG,19,79,98,0.1568173837169929,Dovish
농축수산물/NNG;가격/NNG;안정/NNG,8,22,30,0.2371018816008122,Dovish
파운드/NNG,123,209,332,0.3837306768013144,Dovish
무역전쟁/NNG,33,69,102,0.3118405181923725,Dovish
전망/NNG;fed/NNG;금리/NNG;인하/NNG,9,13,22,0.4514055053553924,Dovish
형태/NNG,389,378,767,0.6710045974668487,Dovish
슬슬/MAG,9,10,19,0.5868271569620102,Dovish
임계점/NNG,9,9,18,0.6520301744022334,Dovish
전망대/NNG,10,13,23,0.5015616726171027,Dovish
이뤄냈/VV,13,23,36,0.3685387942273494,Dovish
스프/NNG,55,54,109,0.6641048072615341,Dovish
경과/NNG,98,108,206,0.5916570101057304,Dovish
진퇴양난/NNG,8,14,22,0.3725886710869905,Dovish
자식/NNG,10,13,23,0.5015616726171027,Dovish
라디우스/NNG,7,10,17,0.4564211220815634,Dovish
수탁생산/NNG,13,12,25,0.7063660222690863,Dovish
연고/NNG,13,17,30,0.4986113098370021,Dovish
금리/NNG;인하/NNG;가능성/NNG;높/VA,36,32,68,0.7335339462025127,Dovish
리보/NNG,261,339,600,0.5020055325043745,Dovish
현금화/NNG,17,19,36,0.5833954192019984,Dovish
경기순환/NNG,70,94,164,0.4855543851931526,Dovish
담보물/NNG,23,22,45,0.681667909602335,Dovish
다뤘/VV,16,14,30,0.7451773421739811,Dovish
민감도/NNG,92,87,179,0.6895031729310975,Dovish
전망/NNG;낮/VA,39,34,73,0.7479169647555032,Dovish
신용시장/NNG,26,34,60,0.4986113098370021,Dovish
출국/NNG,16,25,41,0.4172993116174294,Dovish
휴지기/NNG,15,18,33,0.5433584786685278,Dovish
국지/NNG;위험/NNG,1,18,19,0.0362238985779018,Dovish
연예인/NNG,24,26,50,0.6018740071405232,Dovish
유로/NNG,1557,1551,3108,0.6545525348447953,Dovish
가려/VV,8,16,24,0.3260150872011167,Dovish
복합단지/NNG,14,13,27,0.7021863416639438,Dovish
총계/NNG,11,14,25,0.512309422744612,Dovish
재현/NNG,64,70,134,0.596141873739185,Dovish
투자/NNG;수요/NNG;확보/NNG,10,9,19,0.7244779715580372,Dovish
전망/NNG;내리/VV,19,17,36,0.7287396066848493,Dovish
이슈/NNG,1027,897,1924,0.7465273011271949,Dovish
청취자/NNG,2,20,22,0.0652030174402233,Dovish
금융감독당국/NNG,8,10,18,0.5216241395217869,Dovish
나뉘/VV,33,32,65,0.6724061173523033,Dovish
차이점/NNG,36,40,76,0.5868271569620102,Dovish
채권/NNG,6569,6733,13302,0.636148257188218,Dovish
다녀오/VV,9,14,23,0.4191622549728643,Dovish
맥락/NNG,81,79,160,0.6685372674250748,Dovish
반등시/NNG,18,20,38,0.5868271569620102,Dovish
시장리스크/NNG,30,38,68,0.5147606640017633,Dovish
금리/NNG;상향/NNG,15,21,36,0.4657358388587382,Dovish
이뤄낼/VV,7,15,22,0.3042807480543756,Dovish
인터넷뱅킹/NNG,16,16,32,0.6520301744022335,Dovish
동산/NNG,3,20,23,0.097804526160335,Dovish
레이크/NNG,9,12,21,0.4890226308016751,Dovish
유로존/NNG,996,1514,2510,0.4289445533055644,Dovish
보인다는/VV,144,136,280,0.6903848905435414,Dovish
내수/NNG;회복/NNG;부진/NNG,4,28,32,0.0931471677717476,Dovish
자문사/NNG,13,19,32,0.4461259088015282,Dovish
다니/VV,44,41,85,0.6997396993584944,Dovish
금금/NNG,3,30,33,0.0652030174402233,Dovish
채권은행/NNG,10,16,26,0.4075188590013959,Dovish
행태/NNG,99,112,211,0.5763481005876885,Dovish
지나치/VA,248,214,462,0.7556237535128687,Dovish
초등/NNG,34,34,68,0.6520301744022335,Dovish
미/NNG;국채/NNG;금리/NNG;오르/VV,15,15,30,0.6520301744022334,Dovish
시장성/NNG,44,51,95,0.5625358367391818,Dovish
잔뜩/MAG,10,10,20,0.6520301744022335,Dovish
대체로/MAG,367,332,699,0.7207682951976496,Dovish
수요측면/NNG;물가/NNG;상승/NNG;압력/NNG,16,16,32,0.6520301744022335,Dovish
쏠린/VV,41,56,97,0.4773792348302066,Dovish
불확실성/NNG;제거/NNG,6,11,17,0.3556528224012182,Dovish
입금/NNG,110,111,221,0.6461560286868981,Dovish
순손실/NNG,178,192,370,0.6044863075187372,Dovish
실물/NNG,740,809,1549,0.5964182064989528,Dovish
중수익/NNG,24,30,54,0.5216241395217868,Dovish
이자소득/NNG,101,128,229,0.5144925594892624,Dovish
대량매매/NNG,4,15,19,0.1738747131739289,Dovish
모라토리엄/NNG,6,13,19,0.3009370035702616,Dovish
도박/NNG,10,16,26,0.4075188590013959,Dovish
실물/NNG;경기/NNG;회복/NNG,12,14,26,0.5588830066304858,Dovish
내수/NNG;개선/NNG,11,10,21,0.7172331918424568,Dovish
한숨/NNG,49,45,94,0.7099884121268765,Dovish
스코어/NNG,15,20,35,0.4890226308016751,Dovish
바젤/NNG,24,48,72,0.3260150872011167,Dovish
개인연금/NNG,27,29,56,0.6070625761675967,Dovish
열연/NNG,4,23,27,0.1133965520699536,Dovish
출한/NNG,11,15,26,0.4781554612283045,Dovish
파급/NNG,139,138,277,0.6567550307384815,Dovish
저자/NNG,22,70,92,0.2049237690978448,Dovish
그저/MAG,14,16,30,0.5705264026019543,Dovish
원가경쟁력/NNG,13,16,29,0.5297745167018147,Dovish
제한/NNG,1127,1109,2236,0.6626131709209352,Dovish
시원/NNG,15,14,29,0.6986037582881073,Dovish
다수당/NNG,17,20,37,0.5542256482418985,Dovish
회원사/NNG,59,93,152,0.4136535515024922,Dovish
급전/NNG,90,97,187,0.6049764504762992,Dovish
전통/NNG,74,66,140,0.7310641349358376,Dovish
완화/NNG;경계/NNG,1,17,18,0.0383547161413078,Dovish
돈창/NNG,9,9,18,0.6520301744022334,Dovish
신흥국/NNG;성장/NNG,8,10,18,0.5216241395217869,Dovish
금융투자상품/NNG,28,39,67,0.4681242277759625,Dovish
기업명/NNG,49,69,118,0.4630359209523108,Dovish
양수/NNG,12,28,40,0.2794415033152429,Dovish
환급액/NNG,5,29,34,0.1124189955865919,Dovish
결정짓/VV,11,11,22,0.6520301744022334,Dovish
금융시장/NNG;완화/NNG,10,14,24,0.4657358388587382,Dovish
단일물/NNG,9,11,20,0.5334792336018274,Dovish
투신/NNG,486,613,1099,0.516943988188394,Dovish
가명/NNG,7,13,20,0.3510931708319719,Dovish
crs/NNG,964,1336,2300,0.4704768623680787,Dovish
서비스업/NNG;개선/NNG,8,21,29,0.248392447391327,Dovish
신흥국/NNG;성장/NNG;둔화/NNG,5,19,24,0.1715868880005877,Dovish
수익률표/NNG,11,10,21,0.7172331918424568,Dovish
휴면/NNG,13,24,37,0.3531830111345431,Dovish
인물/NNG,51,63,114,0.5278339507065699,Dovish
대변/NNG,24,36,60,0.4346867829348222,Dovish
대차거래/NNG,8,32,40,0.1630075436005583,Dovish
순이자/NNG,9,15,24,0.39121810464134,Dovish
회계기준/NNG,41,114,155,0.2345020802674699,Dovish
총자본비율/NNG,52,63,115,0.538183636014542,Dovish
초고/NNG,90,96,186,0.611278288502094,Dovish
카드채/NNG,333,316,649,0.6871077470757714,Dovish
쌓인/VV,40,47,87,0.554919297363603,Dovish
프라임/NNG,60,71,131,0.5510114149878029,Dovish
휴직/NNG,33,29,62,0.741965370871507,Dovish
활황기/NNG,9,8,17,0.7335339462025127,Dovish
출구전략/NNG,102,91,193,0.7308470086706353,Dovish
황과/NNG,12,33,45,0.2371018816008121,Dovish
요식업/NNG,15,14,29,0.6986037582881073,Dovish
필요시/NNG,78,109,187,0.4665904000309561,Dovish
국빈/NNG,11,31,42,0.2313655457556312,Dovish
공연/NNG,21,60,81,0.2282105610407817,Dovish
경기/NNG;방어/NNG,9,11,20,0.5334792336018274,Dovish
기축통화/NNG,30,49,79,0.3992021475932041,Dovish
인과관계/NNG,14,17,31,0.5369660259783099,Dovish
주체/NNG,139,138,277,0.6567550307384815,Dovish
극우/NNG,31,75,106,0.2695058054195898,Dovish
원시/NNG,12,12,24,0.6520301744022334,Dovish
신용경색/NNG,45,279,324,0.1051661571616505,Dovish
국채/NNG;금리/NNG;인하/NNG,9,10,19,0.5868271569620102,Dovish
생산기업/NNG,9,8,17,0.7335339462025127,Dovish
유전/NNG,16,24,40,0.4346867829348224,Dovish
세일/NNG,22,24,46,0.5976943265353807,Dovish
질병/NNG,37,37,74,0.6520301744022335,Dovish
디플레이션/NNG;우려/NNG,16,18,34,0.5795823772464298,Dovish
물가/NNG;상승률/NNG;하락/NNG,13,18,31,0.4709106815127242,Dovish
본다고/VV,17,22,39,0.5038414984017259,Dovish
도전/NNG,156,334,490,0.3045410395411629,Dovish
재정거래/NNG,45,40,85,0.7335339462025128,Dovish
금리/NNG;상승/NNG;하락/NNG,8,9,17,0.5795823772464298,Dovish
건설자금/NNG,10,20,30,0.3260150872011167,Dovish
인분/NNG,11,13,24,0.551717839878813,Dovish
국유기업/NNG,12,12,24,0.6520301744022334,Dovish
소비자보호/NNG,13,28,41,0.3027282952581798,Dovish
지원대상기업/NNG,2,26,28,0.0501561672617102,Dovish
금융지주회사/NNG,7,40,47,0.1141052805203908,Dovish
정적/NNG,31,81,112,0.2495424124255461,Dovish
최대금액/NNG,8,11,19,0.4742037632016244,Dovish
건실/NNG,18,24,42,0.4890226308016751,Dovish
중심선/NNG,5,36,41,0.0905597464447546,Dovish
채권시장/NNG;우호적/VAX,23,20,43,0.7498347005625685,Dovish
행운/NNG,45,44,89,0.6668490420022843,Dovish
혼인/NNG,74,71,145,0.6795807451516236,Dovish
보증료/NNG,132,135,267,0.6375406149710727,Dovish
대준/NNG,7,12,19,0.3803509350679695,Dovish
크로나/NNG,41,74,115,0.3612599614931293,Dovish
곧이곧대로/MAG,2,15,17,0.0869373565869644,Dovish
기념식/NNG,12,15,27,0.5216241395217868,Dovish
하회/NNG,734,721,1455,0.6637866130530365,Dovish
당위/NNG,17,20,37,0.5542256482418985,Dovish
공급/NNG;부담/NNG,9,8,17,0.7335339462025127,Dovish
가격차/NNG,14,40,54,0.2282105610407817,Dovish
직장인/NNG,79,94,173,0.5479828061465579,Dovish
기인/NNG,480,412,892,0.7596468051288157,Dovish
이자수익/NNG,257,238,495,0.7040830034511514,Dovish
bis/NNG,326,283,609,0.751101897014587,Dovish
바이어/NNG,20,20,40,0.6520301744022335,Dovish
사금융/NNG,112,106,218,0.688937542764624,Dovish
채권/NNG;금리/NNG;오르/VV,12,19,31,0.4118085312014106,Dovish
각별/NNG,69,85,154,0.5292950827500483,Dovish
부대비용/NNG,10,27,37,0.2414926571860124,Dovish
수요조사/NNG,4,15,19,0.1738747131739289,Dovish
일자/NNG,180,196,376,0.5988032213898064,Dovish
박스/NNG,69,247,316,0.1821460811083162,Dovish
보고회/NNG,7,25,32,0.1825684488326253,Dovish
당부/NNG,285,284,569,0.654326055298016,Dovish
부동산투자회사/NNG,26,29,55,0.5845787770502784,Dovish
급변/NNG,92,95,187,0.631439747842163,Dovish
매년/NNG,7,16,23,0.2852632013009771,Dovish
되팔/VV,9,12,21,0.4890226308016751,Dovish
수주/NNG;증가/NNG,9,9,18,0.6520301744022334,Dovish
소비/NNG;심리/NNG;악화/NNG,5,15,20,0.2173433914674111,Dovish
금리/NNG;약간/MAG;높/VA,1,18,19,0.0362238985779018,Dovish
발한다/VV,4,21,25,0.1241962236956635,Dovish
행지/NNG,10,9,19,0.7244779715580372,Dovish
견지/NNG,47,59,106,0.5194138677441521,Dovish
거시경제금융회의/NNG,2,52,54,0.0250780836308551,Dovish
금리/NNG;압박/NNG,8,12,20,0.4346867829348224,Dovish
균형점/NNG,7,20,27,0.2282105610407817,Dovish
보복관세/NNG,7,16,23,0.2852632013009771,Dovish
증권화/NNG,8,14,22,0.3725886710869905,Dovish
도민/NNG,10,11,21,0.5927547040020305,Dovish
텐트/NNG,19,49,68,0.2528280268090293,Dovish
사우나/NNG,15,13,28,0.752342508925654,Dovish
개발사업/NNG,111,100,211,0.7237534935864792,Dovish
가져볼/VV,10,15,25,0.4346867829348223,Dovish
금융시장/NNG;불확실성/NNG;확대/NNG,13,20,33,0.4238196133614518,Dovish
전채/NNG,112,136,248,0.5369660259783099,Dovish
위험/NNG;고금리/NNG,7,16,23,0.2852632013009771,Dovish
보광/NNG,7,10,17,0.4564211220815634,Dovish
고변동성/NNG;높/VA,5,15,20,0.2173433914674111,Dovish
프라이빗에쿼티/NNG,29,49,78,0.3858954093400974,Dovish
바트/NNG,25,52,77,0.3134760453856892,Dovish
재무장/NNG,5,17,22,0.1917735807065392,Dovish
기프티콘/NNG,15,17,32,0.5753207421196178,Dovish
들여오/VV,10,10,20,0.6520301744022335,Dovish
회관/NNG,65,138,203,0.3071156618561245,Dovish
부동산/NNG;pf/NNG;부실/NNG,162,140,302,0.7544920589511559,Dovish
집값/NNG;하향/NNG,4,14,18,0.1862943355434952,Dovish
요국/NNG,27,29,56,0.6070625761675967,Dovish
장기채권형/NNG,46,115,161,0.2608120697608934,Dovish
경제/NNG;성장/NNG;둔화/NNG,15,22,37,0.4445660280015228,Dovish
fed/NNG;금리/NNG;인상/NNG,94,81,175,0.7566769925161723,Dovish
윤리/NNG,8,15,23,0.3477494263478579,Dovish
로티/NNG,7,19,26,0.2402216432008228,Dovish
이체/NNG,101,89,190,0.7399443552205122,Dovish
정말/MAG,114,134,248,0.5547122379242881,Dovish
消費/NNG,4,13,17,0.2006246690468411,Dovish
수요우위/NNG,10,23,33,0.2834913801748841,Dovish
그러/VA,49,55,104,0.5808996099219899,Dovish
무보/NNG,72,101,173,0.4648135896728793,Dovish
결정자/NNG,3,15,18,0.1304060348804467,Dovish
자산배분/NNG,127,117,244,0.707759249137467,Dovish
투자/NNG;위축/NNG,14,22,36,0.4149282928014213,Dovish
물가/NNG;하방/NNG;압력/NNG,8,11,19,0.4742037632016244,Dovish
장애물/NNG,18,21,39,0.5588830066304858,Dovish
다다랐/VV,14,16,30,0.5705264026019543,Dovish
부동산/NNG;살/VV,7,10,17,0.4564211220815634,Dovish
추천종목/NNG,112,214,326,0.3412494370703278,Dovish
담배가격/NNG,7,36,43,0.1267836450226565,Dovish
순증/NNG,98,95,193,0.672620600962304,Dovish
재정/NNG;적자/NNG,91,79,170,0.7510727325392816,Dovish
예상/NNG;소폭/MAG;상회/NNG,10,10,20,0.6520301744022335,Dovish
신뢰도/NNG,51,55,106,0.6046097980820709,Dovish
채권시장/NNG;금리/NNG;인상/NNG,9,9,18,0.6520301744022334,Dovish
점인/NNG,20,24,44,0.5433584786685279,Dovish
성장/NNG;낮/VA,7,12,19,0.3803509350679695,Dovish
들어와/VV,31,38,69,0.5319193528018221,Dovish
우승/NNG,28,33,61,0.5532377237352284,Dovish
돈가스/NNG,4,21,25,0.1241962236956635,Dovish
약화/NNG,1195,1227,2422,0.6350253124781329,Dovish
내연기관/NNG,23,21,44,0.7141282862500653,Dovish
똑똑/NNG,24,23,47,0.6803793124197218,Dovish
성일/NNG,8,11,19,0.4742037632016244,Dovish
유통시장/NNG,109,159,268,0.4469892390556192,Dovish
드물/VA,50,45,95,0.7244779715580372,Dovish
심야/NNG,8,14,22,0.3725886710869905,Dovish
농림/NNG,31,32,63,0.6316542314521637,Dovish
사놓/VV,7,10,17,0.4564211220815634,Dovish
여천/NNG,24,22,46,0.7113056448024364,Dovish
한국판/NNG,11,11,22,0.6520301744022334,Dovish
표결/NNG,35,31,66,0.736163100131554,Dovish
갈아타/VV,291,605,896,0.313621125208347,Dovish
명지/NNG,10,11,21,0.5927547040020305,Dovish
가전제품/NNG,27,29,56,0.6070625761675967,Dovish
뚜렷이/MAG,22,30,52,0.4781554612283045,Dovish
차례차례/MAG,8,9,17,0.5795823772464298,Dovish
부동산/NNG;가격/NNG;상승/NNG,43,41,84,0.6838365243730742,Dovish
아침/NNG,67,96,163,0.4550627258848921,Dovish
상환기간/NNG,20,20,40,0.6520301744022335,Dovish
개회사/NNG,10,22,32,0.2963773520010152,Dovish
인구비중/NNG,4,32,36,0.0815037718002791,Dovish
수출/NNG;증대/NNG,10,19,29,0.3431737760011755,Dovish
환급/NNG,164,243,407,0.4400532864278448,Dovish
핵보유국/NNG,2,16,18,0.0815037718002791,Dovish
구조개혁/NNG,82,106,188,0.5044007009526712,Dovish
프랑/NNG,37,52,89,0.46394454717082,Dovish
추계/NNG,27,39,66,0.4514055053553923,Dovish
대리인/NNG,14,20,34,0.4564211220815634,Dovish
초단/NNG,12,13,25,0.6018740071405232,Dovish
외평채/NNG,85,177,262,0.3131218351649144,Dovish
안내문/NNG,12,14,26,0.5588830066304858,Dovish
거래주체/NNG,18,21,39,0.5588830066304858,Dovish
재인/NNG,4,21,25,0.1241962236956635,Dovish
하향/NNG;추세/NNG,20,20,40,0.6520301744022335,Dovish
상승률/NNG;그치/VV,10,9,19,0.7244779715580372,Dovish
신용등급/NNG;강등/NNG,19,26,45,0.4764835889862476,Dovish
환금성/NNG,24,24,48,0.6520301744022334,Dovish
알선/NNG,8,11,19,0.4742037632016244,Dovish
부수/NNG,11,11,22,0.6520301744022334,Dovish
직종/NNG,5,22,27,0.1481886760005076,Dovish
미화/NNG,12,15,27,0.5216241395217868,Dovish
소비자/NNG;물가/NNG;상승률/NNG;둔화/NNG,26,29,55,0.5845787770502784,Dovish
부실채권/NNG,571,668,1239,0.5573491460833464,Dovish
장기추세/NNG,23,61,84,0.2458474428073995,Dovish
대중화/NNG,44,41,85,0.6997396993584944,Dovish
유휴생산능력/NNG,16,53,69,0.1968392979327497,Dovish
예상밖/NNG;약화/NNG,2,28,30,0.0465735838858738,Dovish
생산함수/NNG,8,11,19,0.4742037632016244,Dovish
fx스왑/NNG,23,37,60,0.4053160543581451,Dovish
수명/NNG,16,24,40,0.4346867829348224,Dovish
평균값/NNG,19,18,37,0.6882540729801354,Dovish
실상/NNG,12,26,38,0.3009370035702616,Dovish
불안/NNG;확대/NNG,10,16,26,0.4075188590013959,Dovish
러시/NNG,12,12,24,0.6520301744022334,Dovish
시켜/VV,7,12,19,0.3803509350679695,Dovish
특가/NNG,13,13,26,0.6520301744022335,Dovish
실리콘/NNG,25,43,68,0.3790873106989729,Dovish
자금조달계획/NNG,10,17,27,0.3835471614130785,Dovish
현금비중/NNG,12,18,30,0.4346867829348222,Dovish
해외진출/NNG,120,115,235,0.6803793124197218,Dovish
추천/NNG,478,452,930,0.6895363348766982,Dovish
선물거래/NNG,13,16,29,0.5297745167018147,Dovish
상임/NNG,41,48,89,0.5569424406352411,Dovish
인도량/NNG,29,33,62,0.5729962138686294,Dovish
신흥/NNG,72,148,220,0.3172038686281136,Dovish
명과/NNG,7,10,17,0.4564211220815634,Dovish
로컬통화/NNG,8,23,31,0.2267931041399073,Dovish
무보증/NNG,328,568,896,0.3765244669083319,Dovish
하향/NNG;등급/NNG;하향/NNG,10,14,24,0.4657358388587382,Dovish
본인/NNG,208,231,439,0.5871094211067731,Dovish
묶이/VV,20,19,39,0.6863475520023511,Dovish
전적/NNG,16,34,50,0.3068377291304628,Dovish
대학가/NNG,7,14,21,0.3260150872011167,Dovish
시프트/NNG,5,15,20,0.2173433914674111,Dovish
부족분/NNG,9,10,19,0.5868271569620102,Dovish
자가/NNG,19,19,38,0.6520301744022335,Dovish
전환율/NNG,55,50,105,0.7172331918424568,Dovish
주택구입자금/NNG,24,50,74,0.312974483713072,Dovish
위쪽/NNG,12,25,37,0.312974483713072,Dovish
박사/NNG,49,45,94,0.7099884121268765,Dovish
증권투자신탁/NNG,7,13,20,0.3510931708319719,Dovish
전치/NNG,13,15,28,0.565092817815269,Dovish
디플레이션/NNG;경기/NNG;침체/NNG,9,9,18,0.6520301744022334,Dovish
통신부/NNG,8,13,21,0.4012493380936822,Dovish
야구/NNG,11,21,32,0.3415396151630747,Dovish
광의/NNG,70,77,147,0.5927547040020305,Dovish
태스크포스/NNG,53,49,102,0.7052571274146607,Dovish
용자/NNG,38,38,76,0.6520301744022335,Dovish
우여곡절/NNG,7,10,17,0.4564211220815634,Dovish
스위프트/NNG,4,40,44,0.0652030174402233,Dovish
배당소득세/NNG,44,52,96,0.551717839878813,Dovish
원화채권/NNG,80,221,301,0.2360290224080483,Dovish
받아들여진다/VV,9,11,20,0.5334792336018274,Dovish
인플레이션/NNG;통제/NNG,9,9,18,0.6520301744022334,Dovish
자유예금/NNG,6,12,18,0.3260150872011167,Dovish
중기업/NNG,10,11,21,0.5927547040020305,Dovish
중중/NNG,5,16,21,0.2037594295006979,Dovish
높/VA;긴축/NNG,15,20,35,0.4890226308016751,Dovish
로컬/NNG,21,40,61,0.3423158415611726,Dovish
부채/NNG;늘/VV,27,25,52,0.7041925883544121,Dovish
상당부분/NNG,302,316,618,0.6231427616122611,Dovish
고금리/NNG;높/VA,15,28,43,0.3493018791440536,Dovish
전망/NNG;확산/NNG,21,22,43,0.622392439202132,Dovish
플래트닝/NNG,134,154,288,0.567350930973372,Dovish
자본총계/NNG,28,29,57,0.6295463752849151,Dovish
보관/NNG,104,102,206,0.6648150797826695,Dovish
반납/NNG,130,130,260,0.6520301744022334,Dovish
구미/NNG,6,16,22,0.2445113154008375,Dovish
내쉬/VV,7,11,18,0.4149282928014213,Dovish
진흥원/NNG,21,32,53,0.4278948019514658,Dovish
무역장벽/NNG,10,18,28,0.3622389857790186,Dovish
답변/NNG,522,649,1171,0.5244372126933219,Dovish
주식자산/NNG,3,14,17,0.1397207516576214,Dovish
루피아/NNG,56,74,130,0.4934282400881767,Dovish
우량기업/NNG,38,50,88,0.4955429325456975,Dovish
기간프리미엄/NNG,16,33,49,0.3161358421344162,Dovish
재정/NNG;부양/NNG,4,22,26,0.1185509408004061,Dovish
금리/NNG;하향/NNG,54,54,108,0.6520301744022334,Dovish
소비/NNG;투자/NNG;내수/NNG;부진/NNG,5,13,18,0.2507808363085513,Dovish
금리/NNG;인하/NNG;제한/NNG,4,21,25,0.1241962236956635,Dovish
오금/NNG,3,21,24,0.0931471677717476,Dovish
이득/NNG,43,55,98,0.5097690454417462,Dovish
재벌/NNG,13,13,26,0.6520301744022335,Dovish
외생변수/NNG,12,18,30,0.4346867829348222,Dovish
긴박/NNG,11,10,21,0.7172331918424568,Dovish
포스/NNG,51,120,171,0.2771128241209492,Dovish
신용스프레드/NNG;확대/NNG,16,29,45,0.3597407858770944,Dovish
대출태도/NNG,48,56,104,0.5588830066304858,Dovish
출처/NNG,10,50,60,0.1304060348804467,Dovish
경제/NNG;상승/NNG,7,14,21,0.3260150872011167,Dovish
자산/NNG;감소/NNG,11,17,28,0.4219018775543863,Dovish
탄탄/NNG;성장/NNG,10,10,20,0.6520301744022335,Dovish
상상/NNG,120,123,243,0.6361269994168132,Dovish
가계/NNG;부채/NNG;부담/NNG,8,10,18,0.5216241395217869,Dovish
매수주체/NNG,26,25,51,0.6781113813783228,Dovish
거촌/NNG,6,11,17,0.3556528224012182,Dovish
약액/NNG,16,35,51,0.2980709368695925,Dovish
순현금/NNG,10,11,21,0.5927547040020305,Dovish
산업군/NNG,17,31,48,0.3575649343496119,Dovish
대출시/NNG,18,17,35,0.6903848905435414,Dovish
수수/NNG,11,35,46,0.2049237690978448,Dovish
억눌렸/VV,7,10,17,0.4564211220815634,Dovish
마이너스금리/NNG,200,370,570,0.3524487429201262,Dovish
사이클/NNG,1221,1280,2501,0.6219756585508806,Dovish
ted스프레드/NNG,25,49,74,0.3326684563276701,Dovish
환시/NNG,50,52,102,0.6269520907713784,Dovish
결정과정/NNG,11,10,21,0.7172331918424568,Dovish
임대주택/NNG,140,138,278,0.6614798870747297,Dovish
부동자금/NNG,18,24,42,0.4890226308016751,Dovish
그냥/MAG,95,122,217,0.5077284144935424,Dovish
브이/NNG,49,50,99,0.6389895709141888,Dovish
범주/NNG,17,17,34,0.6520301744022335,Dovish
안전자산/NNG;선호/NNG;강화/NNG,17,17,34,0.6520301744022335,Dovish
외환당국/NNG,229,200,429,0.7465745496905573,Dovish
직영/NNG,17,20,37,0.5542256482418985,Dovish
달러인덱스/NNG;강세/NNG,5,13,18,0.2507808363085513,Dovish
채권/NNG;발행/NNG;성공/NNG,4,16,20,0.1630075436005583,Dovish
딥러닝/NNG,7,16,23,0.2852632013009771,Dovish
터치/NNG,138,126,264,0.7141282862500653,Dovish
국채/NNG;발행/NNG;늘/VV,8,10,18,0.5216241395217869,Dovish
향유/NNG,10,10,20,0.6520301744022335,Dovish
대내외/NNG;금융시장/NNG;불확실성/NNG,1,17,18,0.0383547161413078,Dovish
화상/NNG,31,38,69,0.5319193528018221,Dovish
채권/NNG;가격/NNG;상승/NNG,29,46,75,0.411062501253582,Dovish
신용공여/NNG,46,53,99,0.5659129815566555,Dovish
금리/NNG;인하/NNG;하향/NNG,8,9,17,0.5795823772464298,Dovish
나열/NNG,12,15,27,0.5216241395217868,Dovish
수신액/NNG,5,13,18,0.2507808363085513,Dovish
다뤄질/VV,8,13,21,0.4012493380936822,Dovish
가수/NNG,11,29,40,0.2473217902905023,Dovish
일본식/NNG,2,15,17,0.0869373565869644,Dovish
지정학/NNG;위험/NNG;증대/NNG,9,8,17,0.7335339462025127,Dovish
대출비율/NNG,10,31,41,0.2103323143233011,Dovish
로드쇼/NNG,6,24,30,0.1630075436005583,Dovish
중도상환수수료/NNG,85,231,316,0.2399245230484409,Dovish
승자/NNG,26,23,49,0.7370775884546988,Dovish
이자/NNG;부담/NNG;줄/VV,15,15,30,0.6520301744022334,Dovish
도매/NNG,128,118,246,0.7072869688431008,Dovish
수요/NNG;진작/NNG,14,13,27,0.7021863416639438,Dovish
중과/NNG,33,30,63,0.7172331918424568,Dovish
급박/NNG,8,9,17,0.5795823772464298,Dovish
부도율/NNG,96,90,186,0.6954988526957157,Dovish
일비/NNG,390,516,906,0.4928135039086648,Dovish
경연/NNG,7,61,68,0.0748231347674694,Dovish
수익성/NNG;오르/VV,8,9,17,0.5795823772464298,Dovish
어쨌든/MAG,9,16,25,0.3667669731012563,Dovish
자인/NNG,7,11,18,0.4149282928014213,Dovish
미지근/NNG,10,11,21,0.5927547040020305,Dovish
오픈런/NNG,9,12,21,0.4890226308016751,Dovish
스스로/NNG,24,35,59,0.4471064053043886,Dovish
특약/NNG,52,46,98,0.7370775884546988,Dovish
수출입금융/NNG,16,19,35,0.5490780416018809,Dovish
예대마진/NNG;축소/NNG,5,13,18,0.2507808363085513,Dovish
우체국/NNG,12,18,30,0.4346867829348222,Dovish
주식펀드/NNG,242,246,488,0.6414280577452867,Dovish
가령/MAG,83,117,200,0.4625513203024391,Dovish
생산성/NNG,245,321,566,0.4976554290608947,Dovish
퇴장/NNG,7,11,18,0.4149282928014213,Dovish
스트레스금리/NNG,4,183,187,0.0142520256699941,Dovish
부동산중개/NNG,15,13,28,0.752342508925654,Dovish
공일/NNG,1,16,17,0.0407518859001395,Dovish
미결/NNG,18,29,47,0.4047083841117311,Dovish
소득/NNG;높/VA,11,32,43,0.2241353724507677,Dovish
통화/NNG;긴축/NNG;선호/NNG,10,10,20,0.6520301744022335,Dovish
최후/NNG,21,21,42,0.6520301744022335,Dovish
물류센터/NNG,114,98,212,0.7584840804270879,Dovish
변동비/NNG,8,9,17,0.5795823772464298,Dovish
설문/NNG,58,57,115,0.6634693002689394,Dovish
저작권/NNG,64,123,187,0.3392677330223004,Dovish
심리/NNG;약화/NNG,7,10,17,0.4564211220815634,Dovish
궁극적/VAX,86,89,175,0.6300516291976638,Dovish
대출/NNG;청약/NNG;철회/NNG,3,16,19,0.1222556577004187,Dovish
특수목적회사/NNG,8,9,17,0.5795823772464298,Dovish
미지급/NNG,7,20,27,0.2282105610407817,Dovish
신종/NNG,124,110,234,0.7350158329625177,Dovish
타임/NNG,23,22,45,0.681667909602335,Dovish
화력/NNG,7,11,18,0.4149282928014213,Dovish
탑승/NNG,8,16,24,0.3260150872011167,Dovish
여신/NNG;성장/NNG,10,9,19,0.7244779715580372,Dovish
중앙값/NNG,24,22,46,0.7113056448024364,Dovish
정부대책/NNG,23,20,43,0.7498347005625685,Dovish
원래/NNG,20,18,38,0.7244779715580372,Dovish
커버리지/NNG,18,31,49,0.378598165781942,Dovish
fed/NNG;금리/NNG;인상/NNG;가능성/NNG;배제/NNG,8,16,24,0.3260150872011167,Dovish
수록/NNG,240,329,569,0.4756451120259454,Dovish
달인/NNG,15,13,28,0.752342508925654,Dovish
리먼브라더스사태/NNG,32,51,83,0.4091169721739504,Dovish
발급/NNG,206,257,463,0.5226389724780549,Dovish
개표/NNG,11,11,22,0.6520301744022334,Dovish
아젠다/NNG,8,10,18,0.5216241395217869,Dovish
소설/NNG,12,12,24,0.6520301744022334,Dovish
구조변화/NNG,27,40,67,0.4401203677215076,Dovish
신용경색/NNG;완화/NNG,2,18,20,0.0724477971558037,Dovish
진전/NNG,211,324,535,0.4246245888854051,Dovish
제품/NNG;가격/NNG;상승/NNG,8,9,17,0.5795823772464298,Dovish
보호무역/NNG,18,35,53,0.3353298039782915,Dovish
매운/VA,3,38,41,0.0514760664001763,Dovish
금융지주사/NNG,60,76,136,0.5147606640017633,Dovish
장남/NNG,11,10,21,0.7172331918424568,Dovish
순환기/NNG,12,11,23,0.7113056448024364,Dovish
유동성/NNG;증가/NNG,8,11,19,0.4742037632016244,Dovish
커브/NNG,254,373,627,0.4440098238556764,Dovish
결사/NNG,13,13,26,0.6520301744022335,Dovish
최애/NNG,9,16,25,0.3667669731012563,Dovish
기로/NNG,21,19,40,0.7206649296024688,Dovish
비영리단체/NNG,24,44,68,0.3556528224012182,Dovish
수출/NNG;모멘텀/NNG,7,19,26,0.2402216432008228,Dovish
대응력/NNG,34,33,67,0.6717886645356345,Dovish
내몰리/VV,34,31,65,0.7151298686992238,Dovish
대차대조표/NNG;축소/NNG,9,11,20,0.5334792336018274,Dovish
부금/NNG,12,19,31,0.4118085312014106,Dovish
진작/NNG;효과/NNG,14,22,36,0.4149282928014213,Dovish
명심/NNG,12,11,23,0.7113056448024364,Dovish
노후자금/NNG,18,48,66,0.2445113154008375,Dovish
국고채/NNG;금리/NNG;급락/NNG,3,21,24,0.0931471677717476,Dovish
엑스포/NNG,13,19,32,0.4461259088015282,Dovish
출입/NNG,21,27,48,0.5071345800906261,Dovish
메이저/NNG,14,27,41,0.3380897200604173,Dovish
기념행사/NNG,12,30,42,0.2608120697608934,Dovish
기회비용/NNG,16,21,37,0.4967848947826541,Dovish
시장주체/NNG,18,28,46,0.4191622549728643,Dovish
입찰/NNG,745,661,1406,0.7348902873368591,Dovish
요구불예금/NNG,269,353,622,0.496872852448161,Dovish
a+등급/NNG,15,54,69,0.1811194928895092,Dovish
정책/NNG;완화/NNG,18,19,37,0.617712796802116,Dovish
출구/NNG,20,19,39,0.6863475520023511,Dovish
속성/NNG,27,34,61,0.517788667907656,Dovish
배우/NNG,23,25,48,0.5998677604500549,Dovish
앞선다/VV,9,10,19,0.5868271569620102,Dovish
외증/NNG,8,9,17,0.5795823772464298,Dovish
캘린더/NNG,13,24,37,0.3531830111345431,Dovish
행이/NNG,25,65,90,0.2507808363085513,Dovish
분열/NNG,13,20,33,0.4238196133614518,Dovish
납세자/NNG,14,15,29,0.6085614961087512,Dovish
스태프/NNG,2,16,18,0.0815037718002791,Dovish
미래/NNG;위험/NNG,1,19,20,0.0343173776001175,Dovish
레인/NNG,9,44,53,0.1333698084004568,Dovish
주택/NNG;확대/NNG,7,19,26,0.2402216432008228,Dovish
행동주의/NNG,20,38,58,0.3431737760011755,Dovish
마음껏/MAG,8,12,20,0.4346867829348224,Dovish
크기/NNG,48,57,105,0.5490780416018808,Dovish
비관/NNG,88,89,177,0.6447039926673769,Dovish
채안펀드/NNG,7,55,62,0.0829856585602842,Dovish
매입량/NNG,10,12,22,0.5433584786685279,Dovish
매해/MAG,11,10,21,0.7172331918424568,Dovish
주택가격/NNG;상승/NNG,51,50,101,0.6650707778902781,Dovish
만나/NNG,19,19,38,0.6520301744022335,Dovish
코드/NNG,41,39,80,0.6854676192433736,Dovish
함의/NNG,21,56,77,0.2445113154008376,Dovish
떠넘기/VV,10,9,19,0.7244779715580372,Dovish
인구증가율/NNG,6,49,55,0.0798404295186408,Dovish
루머/NNG,15,19,34,0.5147606640017633,Dovish
소비세/NNG,10,52,62,0.1253904181542756,Dovish
외국인지분율/NNG,16,24,40,0.4346867829348224,Dovish
소리/NNG,40,40,80,0.6520301744022335,Dovish
등급간/NNG,10,33,43,0.1975849013340101,Dovish
대출/NNG;규제/NNG;강화/NNG,10,12,22,0.5433584786685279,Dovish
광업/NNG,22,19,41,0.7549823072025862,Dovish
인상기/NNG,51,67,118,0.4963214760375209,Dovish
기대/NNG;멀/VA,10,9,19,0.7244779715580372,Dovish
해암/NNG,6,11,17,0.3556528224012182,Dovish
반감/NNG,24,27,51,0.5795823772464297,Dovish
교전/NNG,7,10,17,0.4564211220815634,Dovish
스캔들/NNG,12,24,36,0.3260150872011167,Dovish
비추/VV,96,107,203,0.5849990349777048,Dovish
전월세/NNG,343,359,702,0.6229703337603512,Dovish
리스트/NNG,35,54,89,0.4226121500755217,Dovish
내심/NNG,18,20,38,0.5868271569620102,Dovish
집수리/NNG,3,26,29,0.0752342508925654,Dovish
분화/NNG,8,9,17,0.5795823772464298,Dovish
장수/NNG,10,12,22,0.5433584786685279,Dovish
알아볼/VV,4,17,21,0.1534188645652314,Dovish
논문/NNG,23,109,132,0.1375843487270768,Dovish
노령/NNG,6,11,17,0.3556528224012182,Dovish
거치기간/NNG,7,13,20,0.3510931708319719,Dovish
중국은행/NNG,7,15,22,0.3042807480543756,Dovish
조금/MAG,535,469,1004,0.743787085938582,Dovish
유로존/NNG;경기/NNG;회복/NNG,4,14,18,0.1862943355434952,Dovish
정화/NNG,13,16,29,0.5297745167018147,Dovish
표출/NNG,32,30,62,0.6954988526957158,Dovish
실세/NNG,40,39,79,0.6687488968228036,Dovish
이격도/NNG,4,13,17,0.2006246690468411,Dovish
리그/NNG,20,67,87,0.1946358729558906,Dovish
농금채/NNG,8,11,19,0.4742037632016244,Dovish
베이시스/NNG,15,18,33,0.5433584786685278,Dovish
접근방법/NNG,16,32,48,0.3260150872011167,Dovish
이동/NNG,469,434,903,0.7046132529830588,Dovish
위기/NNG;넘/VV,10,15,25,0.4346867829348223,Dovish
영국채/NNG,92,87,179,0.6895031729310975,Dovish
교부/NNG,7,12,19,0.3803509350679695,Dovish
고용창출/NNG,68,93,161,0.4767532457994826,Dovish
감독/NNG,192,238,430,0.5260075356522219,Dovish
잠재/NNG;성장률/NNG;하락/NNG,9,20,29,0.2934135784810051,Dovish
재미/NNG,35,32,67,0.7131580032524429,Dovish
랜덤/NNG,7,19,26,0.2402216432008228,Dovish
아쉬움/NNG,18,28,46,0.4191622549728643,Dovish
원조/NNG,17,16,33,0.6927820603023731,Dovish
조기상환/NNG,62,56,118,0.7218905502310442,Dovish
굳건/NNG,21,31,52,0.4416978600789324,Dovish
소호/NNG,31,35,66,0.5775124401848354,Dovish
채권시장/NNG;금리/NNG;인하/NNG,5,32,37,0.1018797147503489,Dovish
고기/NNG,11,15,26,0.4781554612283045,Dovish
채권투자/NNG,562,780,1342,0.4697961000180195,Dovish
이루어져야/VV,16,20,36,0.5216241395217869,Dovish
투자/NNG;감소/NNG,11,23,34,0.3118405181923725,Dovish
안채/NNG,17,27,44,0.410537517216221,Dovish
위탁운용사/NNG,10,22,32,0.2963773520010152,Dovish
결손/NNG,71,80,151,0.5786767797819823,Dovish
대략/NNG,10,12,22,0.5433584786685279,Dovish
퇴임/NNG,20,41,61,0.3180634997084066,Dovish
이자비용/NNG;줄/VV,7,14,21,0.3260150872011167,Dovish
만기금액/NNG,102,109,211,0.6101566769635579,Dovish
신탁등기/NNG,4,70,74,0.037258867108699,Dovish
고군분투/NNG,8,10,18,0.5216241395217869,Dovish
나눈/VV,71,80,151,0.5786767797819823,Dovish
소외/NNG,137,136,273,0.6568245139198969,Dovish
선제/NNG;금리/NNG;내리/VV,7,13,20,0.3510931708319719,Dovish
부조화/NNG,2,18,20,0.0724477971558037,Dovish
상주/NNG,10,9,19,0.7244779715580372,Dovish
개양/NNG,6,11,17,0.3556528224012182,Dovish
여론조사/NNG,44,49,93,0.5854964831366994,Dovish
장단기물/NNG,8,18,26,0.2897911886232149,Dovish
수요층/NNG,33,44,77,0.4890226308016751,Dovish
원천징수/NNG,22,21,43,0.6830792303261494,Dovish
조정대상지역/NNG,11,23,34,0.3118405181923725,Dovish
불능/NNG,12,12,24,0.6520301744022334,Dovish
기원/NNG,13,13,26,0.6520301744022335,Dovish
인내심/NNG,44,48,92,0.5976943265353807,Dovish
선형/NNG,6,15,21,0.2608120697608934,Dovish
종속회사/NNG,16,18,34,0.5795823772464298,Dovish
소재산업/NNG,13,13,26,0.6520301744022335,Dovish
신용정보회사/NNG,3,16,19,0.1222556577004187,Dovish
은행/NNG;위험/NNG,8,17,25,0.3068377291304628,Dovish
만기보유/NNG,33,62,95,0.3470483186334469,Dovish
가도/NNG,9,9,18,0.6520301744022334,Dovish
밀어주/VV,8,11,19,0.4742037632016244,Dovish
커뮤니케이션/NNG,98,89,187,0.7179658100159425,Dovish
제약요인/NNG,27,37,64,0.4758058029421703,Dovish
골목/NNG,43,38,81,0.7378236184025274,Dovish
재연/NNG,42,37,79,0.7401423601322651,Dovish
구조조정/NNG;지연/NNG,9,8,17,0.7335339462025127,Dovish
과다/NNG,42,81,123,0.3380897200604174,Dovish
종가/NNG,1401,1573,2974,0.5807338044103809,Dovish
타인/NNG,7,16,23,0.2852632013009771,Dovish
알릴/VV,10,24,34,0.2716792393342639,Dovish
대내외/NNG;위험/NNG,11,13,24,0.551717839878813,Dovish
공헌/NNG,74,102,176,0.4730414990761302,Dovish
선거/NNG,412,363,775,0.7400452668146563,Dovish
사회경제/NNG,18,25,43,0.4694617255696081,Dovish
생산자/NNG;물가/NNG;하락/NNG,3,16,19,0.1222556577004187,Dovish
안전자산/NNG,642,885,1527,0.4729981604138236,Dovish
불화/NNG,10,9,19,0.7244779715580372,Dovish
단기물/NNG,662,711,1373,0.6070941989511655,Dovish
코코본드/NNG,13,77,90,0.1100830164575199,Dovish
유념/NNG,21,50,71,0.2738526732489381,Dovish
사드/NNG,16,39,55,0.2674995587291214,Dovish
금리/NNG;인상/NNG;우려/NNG;완화/NNG,3,15,18,0.1304060348804467,Dovish
발행재개/NNG,4,20,24,0.1304060348804467,Dovish
유동성함정/NNG,3,42,45,0.0465735838858738,Dovish
열광/NNG,10,11,21,0.5927547040020305,Dovish
그날/NNG,13,16,29,0.5297745167018147,Dovish
별관/NNG,13,53,66,0.1599319295703591,Dovish
펀더멘털/NNG;나쁘/VA;않/VX,2,23,25,0.0566982760349768,Dovish
하한/NNG,14,106,120,0.086117192845578,Dovish
혹시/MAG,30,32,62,0.6112782885020939,Dovish
안정성/NNG,441,431,872,0.6671584847131902,Dovish
입수/NNG,23,21,44,0.7141282862500653,Dovish
드렸/VV,31,39,70,0.5182803950376728,Dovish
워크/NNG,13,53,66,0.1599319295703591,Dovish
선반영/NNG,232,247,479,0.6124332002482518,Dovish
삭제/NNG,84,104,188,0.5266397562479579,Dovish
하도급/NNG,31,55,86,0.3675079164812588,Dovish
회복/NNG;확대/NNG,4,16,20,0.1630075436005583,Dovish
영업현금흐름/NNG,36,36,72,0.6520301744022334,Dovish
특수/NNG,258,275,533,0.6117228545300955,Dovish
어쩔/VV,37,35,72,0.6892890415109326,Dovish
경영지표/NNG,8,10,18,0.5216241395217869,Dovish
유동성/NNG,1670,1893,3563,0.5752194354208823,Dovish
합수/NNG,1,83,84,0.0078557852337618,Dovish
자금/NNG;압박/NNG,6,12,18,0.3260150872011167,Dovish
학년/NNG,6,24,30,0.1630075436005583,Dovish
장기부채/NNG,8,10,18,0.5216241395217869,Dovish
투자/NNG;부진/NNG,10,9,19,0.7244779715580372,Dovish
결정시/NNG,58,135,193,0.2801314823357744,Dovish
모디/NNG,10,48,58,0.1358396196671319,Dovish
크라카타우/NNG,4,45,49,0.0579582377246429,Dovish
특수채/NNG,1185,1276,2461,0.6055295898641432,Dovish
고맙/VA,19,19,38,0.6520301744022335,Dovish
임시직/NNG,6,11,17,0.3556528224012182,Dovish
자료/NNG,12137,14481,26618,0.546487827271591,Dovish
복제/NNG,374,514,888,0.4744344070553216,Dovish
스쿨/NNG,18,17,35,0.6903848905435414,Dovish
매출/NNG;최대/NNG,11,10,21,0.7172331918424568,Dovish
물가/NNG;안정/NNG;금융안정/NNG,11,21,32,0.3415396151630747,Dovish
단기영역/NNG,45,78,123,0.376171254462827,Dovish
깐깐/NNG,11,21,32,0.3415396151630747,Dovish
물가/NNG;전망/NNG;하향/NNG,7,10,17,0.4564211220815634,Dovish
응원/NNG,64,67,131,0.62283479345885,Dovish
복리채/NNG,6,15,21,0.2608120697608934,Dovish
국채입찰/NNG,108,137,245,0.5140091885798629,Dovish
돼지/NNG,10,15,25,0.4346867829348223,Dovish
금은/NNG,9,8,17,0.7335339462025127,Dovish
횡령/NNG,34,41,75,0.5407079495042911,Dovish
기축통화국/NNG,11,25,36,0.2868932767369827,Dovish
복리이자/NNG,11,14,25,0.512309422744612,Dovish
중소기업/NNG;성장/NNG,6,21,27,0.1862943355434952,Dovish
태어난/VV,15,13,28,0.752342508925654,Dovish
놀이/NNG,7,19,26,0.2402216432008228,Dovish
분양보증/NNG,9,28,37,0.2095811274864321,Dovish
최저임금/NNG,219,313,532,0.4562128057319142,Dovish
매출원가/NNG,10,12,22,0.5433584786685279,Dovish
보유고/NNG,5,16,21,0.2037594295006979,Dovish
오산/NNG,10,16,26,0.4075188590013959,Dovish
매몰/NNG,9,10,19,0.5868271569620102,Dovish
수익성/NNG;하락/NNG,13,12,25,0.7063660222690863,Dovish
상품명/NNG,1,16,17,0.0407518859001395,Dovish
세탁기/NNG,16,20,36,0.5216241395217869,Dovish
국고채/NNG;금리/NNG;하락/NNG,35,42,77,0.5433584786685279,Dovish
예금자보호/NNG,22,23,45,0.623681036384745,Dovish
시사점/NNG,101,109,210,0.6041747487580329,Dovish
어찌/MAG,20,34,54,0.3835471614130785,Dovish
오차/NNG,8,60,68,0.0869373565869644,Dovish
실익/NNG,8,10,18,0.5216241395217869,Dovish
발권/NNG,4,22,26,0.1185509408004061,Dovish
저점/NNG,441,398,839,0.7224756455059924,Dovish
안타깝/VA,20,21,41,0.6209811184783176,Dovish
글로벌/NNG;경기/NNG;둔화/NNG;우려/NNG,14,19,33,0.4804432864016457,Dovish
기울여야/VV,26,30,56,0.565092817815269,Dovish
자산총계/NNG,23,33,56,0.4544452730682233,Dovish
아태/NNG,17,30,47,0.3694837654945989,Dovish
국제/NNG;유가/NNG;급락/NNG,9,9,18,0.6520301744022334,Dovish
신용정보원/NNG,19,36,55,0.3441270364900677,Dovish
실험/NNG,24,24,48,0.6520301744022334,Dovish
코픽스/NNG;상승/NNG,10,24,34,0.2716792393342639,Dovish
전성시대/NNG,8,19,27,0.2745390208009404,Dovish
bei/NNG,56,112,168,0.3260150872011167,Dovish
투기등급/NNG,51,47,98,0.7075221041385937,Dovish
담보인정비율/NNG,12,16,28,0.4890226308016751,Dovish
슬라이드/NNG,5,30,35,0.1086716957337055,Dovish
금리/NNG;인상/NNG;미루/VV,8,9,17,0.5795823772464298,Dovish
대폭/NNG,10,16,26,0.4075188590013959,Dovish
중저가/NNG,35,40,75,0.5705264026019543,Dovish
축구/NNG,15,39,54,0.2507808363085513,Dovish
의혹/NNG,43,51,94,0.5497509313587459,Dovish
낮/VA;완화/NNG,5,13,18,0.2507808363085513,Dovish
중진/NNG,21,22,43,0.622392439202132,Dovish
에스/NNG,231,226,457,0.6664556207385661,Dovish
델타/NNG,16,22,38,0.4742037632016244,Dovish
크레센도/NNG,3,31,34,0.0630996942969903,Dovish
상속세/NNG,125,113,238,0.7212723168166298,Dovish
중국발/NNG,28,29,57,0.6295463752849151,Dovish
건전화/NNG,23,28,51,0.5355962146875489,Dovish
인적분할/NNG,13,13,26,0.6520301744022335,Dovish
활용도/NNG,44,50,94,0.5737865534739655,Dovish
재정/NNG;확대/NNG,25,23,48,0.7087284504372103,Dovish
만호/NNG,40,53,93,0.4920982448318743,Dovish
저해/NNG,71,85,156,0.5446369692065716,Dovish
국채/NNG;금리/NNG;넘/VV,9,16,25,0.3667669731012563,Dovish
아름다운/VA,10,9,19,0.7244779715580372,Dovish
타당/NNG,88,82,170,0.6997396993584944,Dovish
대출실행일/NNG,12,64,76,0.1222556577004187,Dovish
거칠/VV,11,10,21,0.7172331918424568,Dovish
일시/NNG,46,47,93,0.6381571919681435,Dovish
보증비율/NNG,11,46,57,0.1559202590961862,Dovish
경차/NNG,8,10,18,0.5216241395217869,Dovish
마시/VV,16,20,36,0.5216241395217869,Dovish
실무회의/NNG,6,15,21,0.2608120697608934,Dovish
지수/NNG;내리/VV,76,69,145,0.7181781631097065,Dovish
사흘/NNG,82,90,172,0.5940719366775905,Dovish
가계/NNG;대출/NNG;증가/NNG,50,61,111,0.5344509626247815,Dovish
엿보인다/VV,11,10,21,0.7172331918424568,Dovish
대응책/NNG,40,56,96,0.4657358388587382,Dovish
분과/NNG,15,29,44,0.3372569867597759,Dovish
발행세/NNG,6,18,24,0.2173433914674111,Dovish
금리연동/NNG,4,14,18,0.1862943355434952,Dovish
미국발/NNG,92,84,176,0.7141282862500653,Dovish
생활고/NNG,11,12,23,0.5976943265353807,Dovish
전산/NNG,163,169,332,0.628881174127598,Dovish
액화석유가스/NNG,20,19,39,0.6863475520023511,Dovish
간신히/MAG,26,23,49,0.7370775884546988,Dovish
명칭/NNG,68,65,133,0.6821238747592596,Dovish
단순화/NNG,11,10,21,0.7172331918424568,Dovish
해요/VV,11,22,33,0.3260150872011167,Dovish
부동산/NNG;대출/NNG;부실/NNG,7,11,18,0.4149282928014213,Dovish
적자국채발행/NNG,16,17,33,0.6136754582609257,Dovish
불공정거래/NNG,10,9,19,0.7244779715580372,Dovish
표준/NNG,67,58,125,0.7532072704301663,Dovish
의거/NNG,12,26,38,0.3009370035702616,Dovish
실업률/NNG;낮/VA,12,12,24,0.6520301744022334,Dovish
증권자금/NNG,8,24,32,0.2173433914674112,Dovish
경영실태평가/NNG,7,11,18,0.4149282928014213,Dovish
디스카운트/NNG,30,37,67,0.5286731143801893,Dovish
예상/NNG;상승/NNG,17,16,33,0.6927820603023731,Dovish
금리/NNG;인상/NNG;가능성/NNG;배제/NNG,18,25,43,0.4694617255696081,Dovish
중장기영역/NNG,17,18,35,0.6158062758243317,Dovish
막차/NNG,18,21,39,0.5588830066304858,Dovish
우산/NNG,38,75,113,0.330361955030465,Dovish
경기민감/NNG,10,15,25,0.4346867829348223,Dovish
가리킨다/VV,13,17,30,0.4986113098370021,Dovish
안전판/NNG,24,64,88,0.2445113154008375,Dovish
채권/NNG;가격/NNG;금리/NNG;반대/NNG,10,9,19,0.7244779715580372,Dovish
조원/NNG,1321,1372,2693,0.6277929011555032,Dovish
약세장/NNG,39,34,73,0.7479169647555032,Dovish
시스템/NNG;위험/NNG,10,40,50,0.1630075436005583,Dovish
조급/NNG,9,22,31,0.2667396168009137,Dovish
즐기/VV,27,27,54,0.6520301744022334,Dovish
증시자금/NNG,10,12,22,0.5433584786685279,Dovish
소극적/VAX,73,69,142,0.6898290250922181,Dovish
재정/NNG;지출/NNG;확대/NNG,22,23,45,0.623681036384745,Dovish
플랫/NNG,12,22,34,0.3556528224012182,Dovish
가격변수/NNG,41,70,111,0.3819033878641653,Dovish
해치/VV,20,18,38,0.7244779715580372,Dovish
매수금액/NNG,10,9,19,0.7244779715580372,Dovish
공청회/NNG,5,28,33,0.1164339597146845,Dovish
완연/NNG,25,39,64,0.4179680605142522,Dovish
추석/NNG,28,34,62,0.5369660259783099,Dovish
주대/NNG,8,14,22,0.3725886710869905,Dovish
단언/NNG,23,30,53,0.4998898003750456,Dovish
직접/NNG,300,262,562,0.7465994363384353,Dovish
공히/MAG,29,35,64,0.5402535730761364,Dovish
강요/NNG,8,10,18,0.5216241395217869,Dovish
학자/NNG,17,16,33,0.6927820603023731,Dovish
외부/NNG;압력/NNG,9,8,17,0.7335339462025127,Dovish
평일/NNG,34,56,90,0.3958754630299275,Dovish
대두/NNG,143,131,274,0.7117581293093084,Dovish
종목군/NNG,6,30,36,0.1304060348804467,Dovish
공포지수/NNG,31,38,69,0.5319193528018221,Dovish
평론가/NNG,11,10,21,0.7172331918424568,Dovish
해외/NNG;투자/NNG;확대/NNG,10,9,19,0.7244779715580372,Dovish
관심주/NNG,1,17,18,0.0383547161413078,Dovish
최대한/MAG,26,48,74,0.3531830111345431,Dovish
mmf/NNG,563,684,1247,0.5366856552462828,Dovish
알차/VA,3,17,20,0.1150641484239235,Dovish
분별/NNG,20,20,40,0.6520301744022335,Dovish
시가/NNG,74,103,177,0.4684488631627697,Dovish
crb/NNG,174,227,401,0.4997940543876151,Dovish
증시주변자금/NNG,16,14,30,0.7451773421739811,Dovish
밀컨글로벌콘퍼런스/NNG,7,12,19,0.3803509350679695,Dovish
총거래량/NNG,122,168,290,0.4734981028397172,Dovish
지배주주/NNG,12,19,31,0.4118085312014106,Dovish
당했/VV,9,11,20,0.5334792336018274,Dovish
본질/NNG,77,76,153,0.6606095188022629,Dovish
자금/NNG;공급/NNG;위축/NNG,1,19,20,0.0343173776001175,Dovish
국공채/NNG,156,227,383,0.4480912211751032,Dovish
인하/NNG;불확실성/NNG;높/VA,4,13,17,0.2006246690468411,Dovish
녹수/NNG,6,11,17,0.3556528224012182,Dovish
유출/NNG,497,593,1090,0.5464738561178921,Dovish
방지/NNG,213,191,404,0.7271331264276216,Dovish
표본/NNG,13,12,25,0.7063660222690863,Dovish
세후/NNG,35,57,92,0.4003694053347048,Dovish
세수/NNG,412,403,815,0.6665916423169236,Dovish
베스트/NNG,76,73,149,0.6788259349941062,Dovish
편익/NNG,31,39,70,0.5182803950376728,Dovish
목돈/NNG,81,93,174,0.567897248672913,Dovish
블록딜/NNG,14,65,79,0.1404372683327887,Dovish
중앙/NNG,476,420,896,0.7389675309891979,Dovish
사회보장/NNG,40,38,78,0.6863475520023511,Dovish
서비스업/NNG;생산/NNG;증가/NNG,5,14,19,0.2328679194293691,Dovish
급여통장/NNG,12,16,28,0.4890226308016751,Dovish
영업이익/NNG;상승/NNG,14,15,29,0.6085614961087512,Dovish
욕심/NNG,15,23,38,0.4252370702623262,Dovish
자산관리자/NNG,10,10,20,0.6520301744022335,Dovish
올리/NNG,7,10,17,0.4564211220815634,Dovish
지니/NNG,25,31,56,0.5258307858082528,Dovish
임계/NNG,19,40,59,0.3097143328410609,Dovish
금융안정/NNG;위험/NNG,9,13,22,0.4514055053553924,Dovish
민간/NNG;소비/NNG;투자/NNG;위축/NNG,5,14,19,0.2328679194293691,Dovish
저하/NNG,530,499,1029,0.6925370589843362,Dovish
경기동향보고서/NNG,19,30,49,0.4129524437880812,Dovish
중산층/NNG,52,53,105,0.6397277182814366,Dovish
자유무역/NNG,15,17,32,0.5753207421196178,Dovish
비전통적/VAX,12,34,46,0.2301282968478471,Dovish
이윤/NNG,30,38,68,0.5147606640017633,Dovish
근로자수/NNG,7,12,19,0.3803509350679695,Dovish
말국/NNG,7,13,20,0.3510931708319719,Dovish
신용스프레드/NNG,731,1250,1981,0.3813072459904261,Dovish
경감/NNG;효과/NNG,13,13,26,0.6520301744022335,Dovish
부각/NNG,729,665,1394,0.7147819505853056,Dovish
화학제품/NNG,23,28,51,0.5355962146875489,Dovish
가동률/NNG,134,118,252,0.7404410455076212,Dovish
물리/NNG,16,22,38,0.4742037632016244,Dovish
동요/NNG,8,12,20,0.4346867829348224,Dovish
크레딧/NNG;시장/NNG;약세/NNG,9,11,20,0.5334792336018274,Dovish
일괄/NNG,71,96,167,0.4822306498183185,Dovish
aa+등급/NNG,14,13,27,0.7021863416639438,Dovish
크레딧/NNG;강세/NNG,14,22,36,0.4149282928014213,Dovish
이차보전/NNG,19,19,38,0.6520301744022335,Dovish
분모/NNG,15,22,37,0.4445660280015228,Dovish
모여/VV,59,55,114,0.6994505507223959,Dovish
부채/NNG;상환능력/NNG;저하/NNG,4,16,20,0.1630075436005583,Dovish
현황/NNG,971,903,1874,0.7011310070261005,Dovish
와도/VV,11,10,21,0.7172331918424568,Dovish
회사채/NNG,5312,7016,12328,0.4936693680764915,Dovish
자산/NNG;건전성/NNG;우려/NNG,9,10,19,0.5868271569620102,Dovish
해외/NNG,3596,3111,6707,0.7536806516073391,Dovish
세월/NNG,12,41,53,0.1908380998250439,Dovish
종합/NNG,1353,1265,2618,0.697388795230215,Dovish
계단/NNG,16,22,38,0.4742037632016244,Dovish
자격/NNG,97,93,190,0.6800744829786738,Dovish
신규연체발생액/NNG,29,37,66,0.5110506772341831,Dovish
예외/NNG,104,115,219,0.589662070763759,Dovish
기대/NNG;안정/NNG,3,23,26,0.0850474140524652,Dovish
가권/NNG,3,16,19,0.1222556577004187,Dovish
수요예측/NNG;흥행/NNG,10,10,20,0.6520301744022335,Dovish
문항/NNG,6,16,22,0.2445113154008375,Dovish
듀레이션/NNG,315,355,670,0.5785619857371931,Dovish
영업이익/NNG;흑자/NNG,8,14,22,0.3725886710869905,Dovish
물가/NNG;상승/NNG;압력/NNG;완화/NNG,10,10,20,0.6520301744022335,Dovish
적정/NNG,375,419,794,0.5835592253003283,Dovish
인기몰이/NNG,6,11,17,0.3556528224012182,Dovish
혜안/NNG,7,11,18,0.4149282928014213,Dovish
육아/NNG,50,43,93,0.7581746213979459,Dovish
머물렀으나/VV,9,10,19,0.5868271569620102,Dovish
역본/NNG,2,30,32,0.0434686782934822,Dovish
특별자금/NNG,9,9,18,0.6520301744022334,Dovish
민주주의/NNG,8,9,17,0.5795823772464298,Dovish
등록제/NNG,10,19,29,0.3431737760011755,Dovish
중기물/NNG,23,36,59,0.4165748336458714,Dovish
날짜/NNG,47,71,118,0.4316256084071123,Dovish
유기/NNG,23,39,62,0.3845306156731121,Dovish
그리드/NNG,10,9,19,0.7244779715580372,Dovish
첨언/NNG,83,132,215,0.409988670268071,Dovish
설령/MAG,28,35,63,0.5216241395217869,Dovish
수요예측/NNG,1021,1061,2082,0.6274484524643548,Dovish
마이너스성장/NNG,22,46,68,0.3118405181923725,Dovish
소회/NNG,8,12,20,0.4346867829348224,Dovish
공표/NNG,60,65,125,0.6018740071405232,Dovish
파동/NNG,12,11,23,0.7113056448024364,Dovish
ndf시장/NNG,11,13,24,0.551717839878813,Dovish
중부/NNG,44,67,111,0.4281989205029592,Dovish
플랜/NNG,18,28,46,0.4191622549728643,Dovish
채권스왑/NNG,44,102,146,0.2812679183695909,Dovish
체법/NNG,7,17,24,0.2684830129891549,Dovish
바벨/NNG,39,38,77,0.6691888632022923,Dovish
언론사/NNG,21,19,40,0.7206649296024688,Dovish
성향/NNG,231,244,475,0.6172908618316227,Dovish
여쭤/VV,10,12,22,0.5433584786685279,Dovish
도시개발사업/NNG,25,23,48,0.7087284504372103,Dovish
서다/NNG,8,10,18,0.5216241395217869,Dovish
섣불/VA;금리/NNG;인하/NNG,9,12,21,0.4890226308016751,Dovish
외부충격/NNG,18,39,57,0.3009370035702616,Dovish
처할/VV,10,32,42,0.2037594295006979,Dovish
아이유/NNG,4,13,17,0.2006246690468411,Dovish
군불/NNG,4,14,18,0.1862943355434952,Dovish
와서/VV,16,23,39,0.4535862082798146,Dovish
토신/NNG,1,18,19,0.0362238985779018,Dovish
내수/NNG;위축/NNG,19,22,41,0.563116968801929,Dovish
재무/NNG;안정성/NNG;저하/NNG,11,11,22,0.6520301744022334,Dovish
정상화계획/NNG,14,15,29,0.6085614961087512,Dovish
루피/NNG,60,92,152,0.4252370702623262,Dovish
포럼/NNG,134,136,270,0.6424414953669065,Dovish
무르익/VV,11,23,34,0.3118405181923725,Dovish
금리/NNG;전망/NNG;상향/NNG,4,15,19,0.1738747131739289,Dovish
외환보유액/NNG,216,235,451,0.5993128411526911,Dovish
금리/NNG;인상/NNG;없/VA,8,12,20,0.4346867829348224,Dovish
인하/NNG;인상/NNG,8,14,22,0.3725886710869905,Dovish
투자비/NNG,11,22,33,0.3260150872011167,Dovish
공산당/NNG,8,10,18,0.5216241395217869,Dovish
칭찬/NNG,9,9,18,0.6520301744022334,Dovish
시한/NNG,33,37,70,0.5815404258182082,Dovish
미달액/NNG,8,17,25,0.3068377291304628,Dovish
유입액/NNG,15,14,29,0.6986037582881073,Dovish
풍림/NNG,8,15,23,0.3477494263478579,Dovish
연결회사/NNG,1,29,30,0.0224837991173184,Dovish
축산/NNG,10,18,28,0.3622389857790186,Dovish
공적자금/NNG,24,35,59,0.4471064053043886,Dovish
내실/NNG,51,50,101,0.6650707778902781,Dovish
긴축안/NNG,8,11,19,0.4742037632016244,Dovish
기대/NNG;후퇴/NNG,21,31,52,0.4416978600789324,Dovish
해성/NNG,6,11,17,0.3556528224012182,Dovish
신용거래/NNG,84,86,170,0.6368666819742747,Dovish
소비/NNG;촉진/NNG,10,9,19,0.7244779715580372,Dovish
하락/NNG;둔화/NNG,8,11,19,0.4742037632016244,Dovish
수반/NNG,73,78,151,0.6102333683508083,Dovish
연합자산관리/NNG,64,81,145,0.5151843353301598,Dovish
금리/NNG;인하/NNG;기대/NNG;확산/NNG,17,15,32,0.7389675309891979,Dovish
주안점/NNG,22,25,47,0.5737865534739655,Dovish
채무재조정/NNG,18,41,59,0.2862571497375659,Dovish
변동성/NNG;심하/VA,10,15,25,0.4346867829348223,Dovish
개진/NNG,93,96,189,0.6316542314521637,Dovish
수요측면/NNG,107,94,201,0.7422045602238189,Dovish
등가격/NNG,43,39,82,0.7189050640845138,Dovish
정책수단/NNG,50,117,167,0.2786453736761681,Dovish
보폭/NNG,7,10,17,0.4564211220815634,Dovish
국내외/NNG,979,891,1870,0.7164282163185034,Dovish
기한/VV,6,25,31,0.156487241856536,Dovish
발전사/NNG,5,12,17,0.2716792393342639,Dovish
감시인/NNG,16,18,34,0.5795823772464298,Dovish
영업일/NNG,122,127,249,0.626359695095059,Dovish
공제금/NNG,22,50,72,0.2868932767369827,Dovish
중장기채/NNG,11,12,23,0.5976943265353807,Dovish
공제조합/NNG,6,14,20,0.2794415033152429,Dovish
포린트/NNG,22,49,71,0.2927482415683497,Dovish
에쿼티/NNG,48,47,95,0.6659031568363235,Dovish
국책은행/NNG,18,31,49,0.378598165781942,Dovish
표명/NNG,208,213,421,0.6367243017636834,Dovish
보합권/NNG,159,184,343,0.5634391180975823,Dovish
유효경쟁/NNG,164,181,345,0.5907897712815817,Dovish
장위/NNG,7,10,17,0.4564211220815634,Dovish
신용스프레드/NNG;강세/NNG,6,15,21,0.2608120697608934,Dovish
대입/NNG,9,17,26,0.3451924452717707,Dovish
기대/NNG;강화/NNG,10,9,19,0.7244779715580372,Dovish
평균치/NNG,79,72,151,0.7154219969135617,Dovish
리밸런싱/NNG,45,39,84,0.7523425089256541,Dovish
천명/NNG,22,24,46,0.5976943265353807,Dovish
마테/NNG,12,19,31,0.4118085312014106,Dovish
장기투자기관/NNG,46,60,106,0.4998898003750456,Dovish
산식/NNG,16,14,30,0.7451773421739811,Dovish
유통시스템/NNG,2,27,29,0.0482985314372024,Dovish
요충지/NNG,6,13,19,0.3009370035702616,Dovish
가로막/VV,16,19,35,0.5490780416018809,Dovish
전력공사/NNG,10,14,24,0.4657358388587382,Dovish
수학/NNG,16,17,33,0.6136754582609257,Dovish
뒤따라/VV,10,10,20,0.6520301744022335,Dovish
과징금/NNG,38,39,77,0.6353114519816634,Dovish
재정위험국/NNG,2,44,46,0.0296377352001015,Dovish
중공업/NNG,52,73,125,0.4644598502591252,Dovish
글로벌/NNG;금융시장/NNG;불확실성/NNG;확대/NNG,5,16,21,0.2037594295006979,Dovish
중징계/NNG,12,14,26,0.5588830066304858,Dovish
추정/NNG,1183,1368,2551,0.5638535791797092,Dovish
봉합/NNG,7,16,23,0.2852632013009771,Dovish
생략/NNG,26,25,51,0.6781113813783228,Dovish
문단/NNG,11,12,23,0.5976943265353807,Dovish
계속기업/NNG,8,9,17,0.5795823772464298,Dovish
전망/NNG;금리/NNG;인하/NNG,45,55,100,0.5334792336018275,Dovish
산정/NNG,450,412,862,0.7121688798082647,Dovish
식생활/NNG,2,15,17,0.0869373565869644,Dovish
유턴/NNG,4,19,23,0.1372695104004702,Dovish
듀레이션/NNG;축소/NNG,9,14,23,0.4191622549728643,Dovish
간접금융/NNG,14,23,37,0.3968879322448378,Dovish
비즈/NNG,54,49,103,0.7185638656677675,Dovish
소기업/NNG,54,97,151,0.3629858702857794,Dovish
후순위채/NNG,89,106,195,0.5474592973754602,Dovish
언론/NNG,153,148,301,0.6740582208347414,Dovish
망하/VV,10,16,26,0.4075188590013959,Dovish
안정성/NNG;높/VA,31,36,67,0.5614704279574788,Dovish
분사/NNG,12,30,42,0.2608120697608934,Dovish
벌어져/VV,20,27,47,0.4829853143720248,Dovish
논평/NNG,32,36,68,0.5795823772464298,Dovish
크로네/NNG,28,57,85,0.3202955242677638,Dovish
가끔/MAG,17,15,32,0.7389675309891979,Dovish
점도표/NNG,351,646,997,0.3542764569894489,Dovish
인가/NNG,23,30,53,0.4998898003750456,Dovish
현지생산/NNG,9,21,30,0.2794415033152429,Dovish
대내/NNG,65,90,155,0.4709106815127242,Dovish
명의/NNG,42,39,81,0.7021863416639438,Dovish
명목/NNG,341,325,666,0.6841301214497281,Dovish
계절성/NNG,19,32,51,0.3871429160513261,Dovish
캐리/NNG,300,272,572,0.7191509276495223,Dovish
먹구름/NNG,31,59,90,0.342592125533377,Dovish
도금액/NNG,6,14,20,0.2794415033152429,Dovish
금년도/NNG,20,45,65,0.2897911886232149,Dovish
수익성/NNG;안정/NNG,3,20,23,0.097804526160335,Dovish
외화/NNG,331,374,705,0.5770641383078591,Dovish
곡동/NNG,9,18,27,0.3260150872011167,Dovish
절약/NNG,35,37,72,0.6167853001102209,Dovish
수익/NNG;성장/NNG,11,18,29,0.3984628843569204,Dovish
모양/NNG,26,24,50,0.7063660222690863,Dovish
매직/NNG,15,18,33,0.5433584786685278,Dovish
인하/NNG;없/VA,10,19,29,0.3431737760011755,Dovish
가깝/VV,12,22,34,0.3556528224012182,Dovish
비화/NNG,19,17,36,0.7287396066848493,Dovish
상당폭/NNG,177,168,345,0.6869603623166388,Dovish
예컨대/MAG,95,99,194,0.625685520891032,Dovish
만장/NNG,8,45,53,0.1159164754492859,Dovish
외화유동성비율/NNG,5,34,39,0.0958867903532696,Dovish
시드/NNG,13,15,28,0.565092817815269,Dovish
층간/NNG,18,22,40,0.5334792336018274,Dovish
경제체제/NNG,5,15,20,0.2173433914674111,Dovish
추첨/NNG,162,195,357,0.5416866064264709,Dovish
경로/NNG,846,741,1587,0.7444231140948577,Dovish
중위/NNG,23,22,45,0.681667909602335,Dovish
키오스크/NNG,36,36,72,0.6520301744022334,Dovish
수소/NNG,80,91,171,0.5732133401338316,Dovish
곱한/VV,3,21,24,0.0931471677717476,Dovish
일시/MAG,56,65,121,0.561749073331155,Dovish
철수/NNG,48,51,99,0.6136754582609256,Dovish
녹색경제/NNG,4,17,21,0.1534188645652314,Dovish
a등급/NNG,156,141,297,0.7213950865726838,Dovish
둔감/NNG,15,13,28,0.752342508925654,Dovish
대출/NNG;금리/NNG;오르/VV,20,25,45,0.5216241395217868,Dovish
플레이/NNG,43,39,82,0.7189050640845138,Dovish
구할/VV,13,16,29,0.5297745167018147,Dovish
첨부/NNG,9,19,28,0.308856398401058,Dovish
수업/NNG,5,14,19,0.2328679194293691,Dovish
대상기업/NNG,51,68,119,0.4890226308016751,Dovish
채권/NNG;금리/NNG;급등/NNG,12,11,23,0.7113056448024364,Dovish
허리케인/NNG,15,20,35,0.4890226308016751,Dovish
비내구재/NNG,23,21,44,0.7141282862500653,Dovish
아내/NNG,19,32,51,0.3871429160513261,Dovish
대주단협약/NNG,13,22,35,0.3852905576013198,Dovish
신중히/MAG,33,33,66,0.6520301744022334,Dovish
채권추심/NNG,16,34,50,0.3068377291304628,Dovish
일반화/NNG,12,11,23,0.7113056448024364,Dovish
조약/NNG,13,12,25,0.7063660222690863,Dovish
미진/NNG,17,23,40,0.481935346297303,Dovish
여력/NNG;제한적/VAX,12,13,25,0.6018740071405232,Dovish
위임/NNG,10,10,20,0.6520301744022335,Dovish
정책과제/NNG,21,20,41,0.6846316831223452,Dovish
베스/NNG,28,27,55,0.6761794401208346,Dovish
경합/NNG,21,27,48,0.5071345800906261,Dovish
극적/VAX,28,28,56,0.6520301744022334,Dovish
차기/NNG,72,95,167,0.4941702374416927,Dovish
민간/NNG;소비/NNG;침체/NNG,5,26,31,0.1253904181542756,Dovish
주택담보대출/NNG;확대/NNG,13,21,34,0.4036377270109064,Dovish
괴리/NNG,92,132,224,0.4544452730682233,Dovish
하폭/NNG,18,50,68,0.234730862784804,Dovish
발행주체/NNG,25,35,60,0.4657358388587382,Dovish
입체/NNG,5,16,21,0.2037594295006979,Dovish
똘똘한/VA,4,24,28,0.1086716957337056,Dovish
부채비율/NNG;높/VA,14,16,30,0.5705264026019543,Dovish
국고채/NNG,7692,7938,15630,0.631823645943812,Dovish
기울일/VV,35,36,71,0.6339182251132826,Dovish
국제기구/NNG,54,54,108,0.6520301744022334,Dovish
수요/NNG;물가/NNG;압력/NNG,9,9,18,0.6520301744022334,Dovish
기대/NNG;인플레이션/NNG;낮/VA,6,15,21,0.2608120697608934,Dovish
완비/NNG,7,22,29,0.2074641464007106,Dovish
헤알/NNG,145,300,445,0.3151479176277462,Dovish
중앙정부/NNG,60,70,130,0.5588830066304858,Dovish
상환능력/NNG,184,219,403,0.5478244387671733,Dovish
축하/NNG,37,33,70,0.7310641349358376,Dovish
국유화/NNG,7,10,17,0.4564211220815634,Dovish
경기/NNG;바닥/NNG,17,25,42,0.4433805185935188,Dovish
시납/NNG,8,12,20,0.4346867829348224,Dovish
어서/MAG,25,22,47,0.740943380002538,Dovish
주간사/NNG,31,38,69,0.5319193528018221,Dovish
국제통화/NNG,3,27,30,0.0724477971558037,Dovish
날리/VV,10,9,19,0.7244779715580372,Dovish
특수목적법인/NNG,12,14,26,0.5588830066304858,Dovish
스틸/NNG,20,21,41,0.6209811184783176,Dovish
환류/NNG,8,14,22,0.3725886710869905,Dovish
자동이체/NNG,15,45,60,0.2173433914674111,Dovish
내수/NNG;회복/NNG;어렵/VA,2,16,18,0.0815037718002791,Dovish
권한다/VV,15,20,35,0.4890226308016751,Dovish
투자수단/NNG,13,21,34,0.4036377270109064,Dovish
은행채/NNG,1978,2056,4034,0.6272936210931993,Dovish
완화/NNG;금리/NNG;인하/NNG,11,10,21,0.7172331918424568,Dovish
간섭/NNG,99,141,240,0.4578084203249724,Dovish
범일/NNG,12,23,35,0.3401896562098609,Dovish
수시입출금식/NNG,38,46,84,0.5386336223322798,Dovish
유출입/NNG,135,149,284,0.5907655942570572,Dovish
축소/NNG,3127,2735,5862,0.7454838593622611,Dovish
퇴거/NNG,9,13,22,0.4514055053553924,Dovish
출산/NNG,186,173,359,0.701026661496043,Dovish
알린/VV,10,11,21,0.5927547040020305,Dovish
드림/VV,49,45,94,0.7099884121268765,Dovish
남녀/NNG,14,13,27,0.7021863416639438,Dovish
소망/NNG,7,17,24,0.2684830129891549,Dovish
관장/NNG,13,20,33,0.4238196133614518,Dovish
트일/VV,10,11,21,0.5927547040020305,Dovish
딜링/NNG,4,23,27,0.1133965520699536,Dovish
금하/NNG,6,11,17,0.3556528224012182,Dovish
실효/NNG,225,215,440,0.6823571592581513,Dovish
외려/MAG,12,17,29,0.4602565936956942,Dovish
안도/NNG,60,54,114,0.7244779715580371,Dovish
경기/NNG;확장/NNG,27,28,55,0.6287433824592965,Dovish
테러/NNG,15,47,62,0.2080947365113511,Dovish
코퍼레이션/NNG,32,43,75,0.4852317576946854,Dovish
확연/NNG,21,23,44,0.5953318983672568,Dovish
국가/NNG,2213,1916,4129,0.7531016575950641,Dovish
일봉/NNG,11,15,26,0.4781554612283045,Dovish
외환시장/NNG;불안/NNG,14,19,33,0.4804432864016457,Dovish
출금/NNG,48,70,118,0.4471064053043886,Dovish
대형기업/NNG,12,16,28,0.4890226308016751,Dovish
기업/NNG;실적/NNG;악화/NNG,19,19,38,0.6520301744022335,Dovish
파업/NNG,64,105,169,0.3974279158261233,Dovish
컨셉/NNG,7,11,18,0.4149282928014213,Dovish
디폴트/NNG;위험/NNG,7,20,27,0.2282105610407817,Dovish
딱히/MAG,15,13,28,0.752342508925654,Dovish
동강/NNG,6,11,17,0.3556528224012182,Dovish
이치/NNG,39,58,97,0.4384340827877087,Dovish
깨달/VV,6,12,18,0.3260150872011167,Dovish
수요/NNG;흡수/NNG,4,14,18,0.1862943355434952,Dovish
우량자산/NNG,18,37,55,0.3172038686281136,Dovish
불안/NNG;완화/NNG,14,18,32,0.5071345800906261,Dovish
특수은행/NNG,48,52,100,0.6018740071405232,Dovish
글로벌/NNG;불확실성/NNG,6,17,23,0.2301282968478471,Dovish
사업군/NNG,5,12,17,0.2716792393342639,Dovish
철거/NNG,15,15,30,0.6520301744022334,Dovish
보수당/NNG,18,20,38,0.5868271569620102,Dovish
고령사회/NNG,8,21,29,0.248392447391327,Dovish
취약국/NNG,11,10,21,0.7172331918424568,Dovish
아쉽/VA,63,59,122,0.6962356099549273,Dovish
전망보고서/NNG,50,51,101,0.6392452690217976,Dovish
감안/NNG,1488,1620,3108,0.5989017898213107,Dovish
자산부채/NNG,30,31,61,0.6309969429699034,Dovish
이사장/NNG,114,114,228,0.6520301744022334,Dovish
미흡/NNG,93,111,204,0.5462955515261957,Dovish
더더욱/MAG,14,19,33,0.4804432864016457,Dovish
인플레이션/NNG;우려/NNG;완화/NNG,10,10,20,0.6520301744022335,Dovish
거주자/NNG,76,74,150,0.6696526115482399,Dovish
대외/NNG;위험/NNG;확대/NNG,4,19,23,0.1372695104004702,Dovish
소비자/NNG;물가/NNG;둔화/NNG,73,77,150,0.6181584770306889,Dovish
월비/NNG,69,68,137,0.6616188534375604,Dovish
음영/NNG,150,201,351,0.4865896823897265,Dovish
감사보고서/NNG,30,31,61,0.6309969429699034,Dovish
경제/NNG;고금리/NNG,18,23,41,0.5102844843147915,Dovish
세이프/NNG,11,12,23,0.5976943265353807,Dovish
과대/NNG,10,24,34,0.2716792393342639,Dovish
게시/NNG,207,234,441,0.5767959235096681,Dovish
용수/NNG,18,18,36,0.6520301744022334,Dovish
번지/NNG,52,59,111,0.5746706621850194,Dovish
식별/NNG,15,18,33,0.5433584786685278,Dovish
맹점/NNG,101,91,192,0.7236818419189625,Dovish
민평/NNG,983,1520,2503,0.4216747772614444,Dovish
타나/VV,5,12,17,0.2716792393342639,Dovish
기대/NNG;금리/NNG;인하/NNG,11,16,27,0.4482707449015355,Dovish
성장/NNG;그치/VV,15,27,42,0.3622389857790185,Dovish
수요/NNG;약화/NNG,15,13,28,0.752342508925654,Dovish
양적/VAX,93,100,193,0.6063880621940771,Dovish
화이트리스트/NNG,1,21,22,0.0310490559239158,Dovish
질적/VAX,119,123,242,0.6308259410883398,Dovish
빗금/NNG,1,20,21,0.0326015087201116,Dovish
택지/NNG,25,30,55,0.5433584786685278,Dovish
기틀/NNG,10,16,26,0.4075188590013959,Dovish
에서/NNG,34,31,65,0.7151298686992238,Dovish
스킨케어/NNG,3,36,39,0.0543358478668527,Dovish
경기/NNG;부진/NNG,79,76,155,0.6777682076023217,Dovish
역축/NNG,23,38,61,0.3946498424013518,Dovish
코스메틱/NNG,2,33,35,0.039516980266802,Dovish
노동조합/NNG,28,25,53,0.7302737953305015,Dovish
성장/NNG;제약/NNG,12,25,37,0.312974483713072,Dovish
발행한도/NNG,49,88,137,0.3630622562012436,Dovish
오래가/VV,9,9,18,0.6520301744022334,Dovish
유무/NNG,21,21,42,0.6520301744022335,Dovish
연비/NNG,8,12,20,0.4346867829348224,Dovish
등급별/NNG,116,148,264,0.5110506772341831,Dovish
국민연금기금/NNG,16,20,36,0.5216241395217869,Dovish
이해/NNG,256,241,497,0.692612965340132,Dovish
외생/NNG,15,20,35,0.4890226308016751,Dovish
노동당/NNG,10,15,25,0.4346867829348223,Dovish
청약자금/NNG,2,16,18,0.0815037718002791,Dovish
국채입찰/NNG;부진/NNG,17,21,38,0.52783395070657,Dovish
유동성비율/NNG,13,67,80,0.1265133174213289,Dovish
s&p500/NNG,77,91,168,0.551717839878813,Dovish
공론/NNG,11,13,24,0.551717839878813,Dovish
고난/NNG,15,15,30,0.6520301744022334,Dovish
갈아탄/VV,19,36,55,0.3441270364900677,Dovish
배려/NNG,39,38,77,0.6691888632022923,Dovish
복리/NNG,183,237,420,0.5034663371966613,Dovish
평이/NNG,10,12,22,0.5433584786685279,Dovish
만기일/NNG,161,194,355,0.5411178251482454,Dovish
쿠폰금리/NNG,14,14,28,0.6520301744022334,Dovish
연저점/NNG,18,19,37,0.617712796802116,Dovish
판매업/NNG,9,14,23,0.4191622549728643,Dovish
저평/NNG,31,29,60,0.6969977726368703,Dovish
고민거리/NNG,12,13,25,0.6018740071405232,Dovish
유효/NNG,500,445,945,0.7326181734856556,Dovish
인구수/NNG,11,12,23,0.5976943265353807,Dovish
기업규제/NNG,6,13,19,0.3009370035702616,Dovish
영업부/NNG,21,28,49,0.4890226308016752,Dovish
취약차주/NNG,168,157,325,0.6977138171947468,Dovish
순매수금액/NNG,118,160,278,0.4808722536216472,Dovish
강제집행/NNG,6,15,21,0.2608120697608934,Dovish
그러/NNG,163,179,342,0.5937481476400227,Dovish
임의/NNG,59,59,118,0.6520301744022335,Dovish
적격/NNG,56,97,153,0.376429791407475,Dovish
개선/NNG;조짐/NNG,19,17,36,0.7287396066848493,Dovish
선물옵션/NNG,39,49,88,0.5189627918711655,Dovish
만일/NNG,112,102,214,0.7159547013044133,Dovish
끌어모아/VV,14,13,27,0.7021863416639438,Dovish
평정/NNG,15,30,45,0.3260150872011167,Dovish
매매패턴/NNG,11,11,22,0.6520301744022334,Dovish
주택구입/NNG,80,87,167,0.5995679764618239,Dovish
용채/NNG,4,49,53,0.0532269530124272,Dovish
장단기스프레드/NNG;확대/NNG,11,21,32,0.3415396151630747,Dovish
문화재/NNG,13,28,41,0.3027282952581798,Dovish
시화/NNG,30,38,68,0.5147606640017633,Dovish
피에스/NNG,15,21,36,0.4657358388587382,Dovish
대출/NNG;한도/NNG;줄/VV,14,30,44,0.3042807480543756,Dovish
뒤집/VV,29,25,54,0.7563550023065909,Dovish
정치/NNG;불확실성/NNG,24,21,45,0.745177342173981,Dovish
경제/NNG;지표/NNG;개선/NNG,21,22,43,0.622392439202132,Dovish
빌딩/NNG,834,1105,1939,0.4921205117207807,Dovish
환헤지ㅇ/NNG,4,43,47,0.0606539697118356,Dovish
명백/NNG,26,24,50,0.7063660222690863,Dovish
티어/NNG,15,33,48,0.2963773520010151,Dovish
전망/NNG;지정학/NNG;위험/NNG,7,17,24,0.2684830129891549,Dovish
실업률/NNG,721,670,1391,0.7016623220059857,Dovish
감정/NNG,21,23,44,0.5953318983672568,Dovish
실시간/NNG,108,136,244,0.517788667907656,Dovish
표면적/VAX,29,27,56,0.700328705839436,Dovish
내수/NNG;회복/NNG;약화/NNG,9,20,29,0.2934135784810051,Dovish
내리막/NNG,22,19,41,0.7549823072025862,Dovish
제2차세계대전/NNG,11,11,22,0.6520301744022334,Dovish
절상/NNG;절하/NNG,16,31,47,0.3365317029172818,Dovish
경제/NNG;성장/NNG;견인/NNG,14,19,33,0.4804432864016457,Dovish
유동자금/NNG,5,12,17,0.2716792393342639,Dovish
돈/NNG;넘/VV,8,11,19,0.4742037632016244,Dovish
취약계층/NNG;지원/NNG;강화/NNG,1,22,23,0.0296377352001015,Dovish
복원력/NNG,19,24,43,0.5161905547351016,Dovish
만기도래액/NNG,16,19,35,0.5490780416018809,Dovish
여력/NNG;약화/NNG,6,24,30,0.1630075436005583,Dovish
단편/NNG,8,13,21,0.4012493380936822,Dovish
금리/NNG;변동성/NNG;크/VV,7,10,17,0.4564211220815634,Dovish
주류/NNG,41,50,91,0.5346647430098315,Dovish
초구/NNG,3,14,17,0.1397207516576214,Dovish
저유가/NNG,18,64,82,0.1833834865506281,Dovish
사료/NNG,30,29,59,0.6745139735195519,Dovish
금융규제/NNG,64,78,142,0.5349991174582429,Dovish
요청서/NNG,8,11,19,0.4742037632016244,Dovish
유턴기업/NNG,1,21,22,0.0310490559239158,Dovish
자금/NNG;조달/NNG;비용/NNG;지수/NNG;상승/NNG,1,24,25,0.0271679239334264,Dovish
우르/NNG,7,15,22,0.3042807480543756,Dovish
베어스티프닝/NNG,10,14,24,0.4657358388587382,Dovish
해외/NNG;채권/NNG;발행/NNG;성공/NNG,8,19,27,0.2745390208009404,Dovish
경기/NNG;저점/NNG,18,19,37,0.617712796802116,Dovish
기관차/NNG,10,11,21,0.5927547040020305,Dovish
구축효과/NNG,20,71,91,0.1836704716626009,Dovish
매일/MAG,219,256,475,0.5577914382581608,Dovish
상승률/NNG;높/VA,14,18,32,0.5071345800906261,Dovish
유산/NNG,10,15,25,0.4346867829348223,Dovish
유효수요/NNG,118,107,225,0.7190613138267622,Dovish
주요주주/NNG,7,11,18,0.4149282928014213,Dovish
금리/NNG;인상/NNG;가능성/NNG;높/VA,10,15,25,0.4346867829348223,Dovish
탈퇴/NNG,42,134,176,0.2043676666036851,Dovish
생산성/NNG;향상/NNG,29,80,109,0.2363609382208096,Dovish
상환/NNG,1268,1380,2648,0.5991117834362552,Dovish
종류/NNG,394,452,846,0.5683625856515043,Dovish
광풍/NNG,6,12,18,0.3260150872011167,Dovish
산마/NNG,6,11,17,0.3556528224012182,Dovish
통화정책/NNG;금리/NNG;인하/NNG,10,13,23,0.5015616726171027,Dovish
기대/NNG;성장/NNG,11,10,21,0.7172331918424568,Dovish
최고액/NNG,8,15,23,0.3477494263478579,Dovish
보유자/NNG,40,51,91,0.511396215217438,Dovish
예상/NNG;줄/VV,7,18,25,0.253567290045313,Dovish
상기/NNG,53,61,114,0.5665180203822684,Dovish
주택청약종합저축/NNG,5,18,23,0.1811194928895093,Dovish
위험/NNG;빠지/VV,8,14,22,0.3725886710869905,Dovish
펀더멘털/NNG;우려/NNG,4,16,20,0.1630075436005583,Dovish
로지스틱스/NNG,19,23,42,0.5386336223322798,Dovish
동료/NNG,10,11,21,0.5927547040020305,Dovish
금방/MAG,15,20,35,0.4890226308016751,Dovish
사계/NNG,1,25,26,0.0260812069760893,Dovish
유죄/NNG,5,18,23,0.1811194928895093,Dovish
배율/NNG,22,36,58,0.3984628843569204,Dovish
서경/NNG,32,40,72,0.5216241395217869,Dovish
신청지수/NNG,11,29,40,0.2473217902905023,Dovish
가처분/NNG,74,66,140,0.7310641349358376,Dovish
예상밖/NNG,125,110,235,0.740943380002538,Dovish
비상장사/NNG,6,11,17,0.3556528224012182,Dovish
폭풍/NNG,14,15,29,0.6085614961087512,Dovish
해체/NNG,10,14,24,0.4657358388587382,Dovish
발행기업/NNG,32,58,90,0.3597407858770944,Dovish
gdp/NNG;성장률/NNG;둔화/NNG,5,14,19,0.2328679194293691,Dovish
자립/NNG,60,55,115,0.7113056448024365,Dovish
구직/NNG,25,47,72,0.3468245608522518,Dovish
주택정책/NNG,10,12,22,0.5433584786685279,Dovish
북클로징/NNG,47,42,89,0.7296528142120232,Dovish
경화/NNG,13,17,30,0.4986113098370021,Dovish
참여도/NNG,10,9,19,0.7244779715580372,Dovish
인하/NNG;효과/NNG,40,64,104,0.4075188590013959,Dovish
개념/NNG,108,98,206,0.7185638656677675,Dovish
국민투표/NNG,6,55,61,0.0711305644802436,Dovish
혼재/NNG,73,63,136,0.7555270274819532,Dovish
일러/VV,25,32,57,0.5093985737517449,Dovish
세일즈/NNG,40,106,146,0.2460491224159371,Dovish
행도/NNG,11,15,26,0.4781554612283045,Dovish
나스닥선물/NNG,11,10,21,0.7172331918424568,Dovish
주택담보대출/NNG;금리/NNG;오르/VV,10,10,20,0.6520301744022335,Dovish
기대수익/NNG,40,35,75,0.7451773421739812,Dovish
사립/NNG,9,15,24,0.39121810464134,Dovish
채권/NNG;강세/NNG,7,18,25,0.253567290045313,Dovish
부친/NNG,2,20,22,0.0652030174402233,Dovish
수순/NNG,60,57,117,0.686347552002351,Dovish
fed/NNG;금리/NNG;인하/NNG;가능성/NNG;높/VA,9,8,17,0.7335339462025127,Dovish
하방/NNG,628,745,1373,0.5496308047310102,Dovish
외인/NNG,531,533,1064,0.6495835320967842,Dovish
투자/NNG;수요/NNG;증가/NNG,11,11,22,0.6520301744022334,Dovish
성장/NNG;꺾/VV,9,8,17,0.7335339462025127,Dovish
역관/NNG,4,14,18,0.1862943355434952,Dovish
청약금/NNG,2,32,34,0.0407518859001395,Dovish
경제/NNG;우려/NNG,9,21,30,0.2794415033152429,Dovish
금남/NNG,11,21,32,0.3415396151630747,Dovish
신용/NNG;하락/NNG,9,16,25,0.3667669731012563,Dovish
하락/NNG;확대/NNG,20,20,40,0.6520301744022335,Dovish
무더위/NNG,7,10,17,0.4564211220815634,Dovish
물가채/NNG,48,197,245,0.1588702963010518,Dovish
엄정/NNG,35,40,75,0.5705264026019543,Dovish
점증/NNG,29,36,65,0.5252465293795769,Dovish
전당/NNG,13,17,30,0.4986113098370021,Dovish
따진다/VV,7,10,17,0.4564211220815634,Dovish
실적/NNG;호전/NNG,14,29,43,0.3147731876424575,Dovish
잠재력/NNG,112,185,297,0.3947425920705413,Dovish
기대수명/NNG;증가/NNG,2,34,36,0.0383547161413078,Dovish
교보/NNG,15,27,42,0.3622389857790185,Dovish
챙길/VV,19,27,46,0.4588360486534235,Dovish
금리/NNG;인하/NNG;축소/NNG,19,35,54,0.3539592375326411,Dovish
구성항목/NNG,13,22,35,0.3852905576013198,Dovish
농수산/NNG,6,14,20,0.2794415033152429,Dovish
장외거래/NNG,132,168,300,0.512309422744612,Dovish
국고채/NNG;하락/NNG,14,27,41,0.3380897200604173,Dovish
반란/NNG,6,17,23,0.2301282968478471,Dovish
보가/NNG,10,16,26,0.4075188590013959,Dovish
기승/NNG,9,11,20,0.5334792336018274,Dovish
경제/NNG;활력/NNG;높/VV,5,14,19,0.2328679194293691,Dovish
박스피/NNG,8,12,20,0.4346867829348224,Dovish
예측액/NNG,30,56,86,0.3493018791440536,Dovish
절상/NNG,158,251,409,0.4104413050022027,Dovish
유로달러/NNG,30,67,97,0.2919538094338358,Dovish
자영업/NNG,108,137,245,0.5140091885798629,Dovish
수익자/NNG,26,36,62,0.4709106815127242,Dovish
경제자유구역/NNG,6,12,18,0.3260150872011167,Dovish
취합/NNG,30,30,60,0.6520301744022334,Dovish
일반은행/NNG,74,130,204,0.3711556377366559,Dovish
머스크/NNG,126,150,276,0.5477053464978762,Dovish
연체/NNG;증가/NNG,15,18,33,0.5433584786685278,Dovish
과감/NNG,94,121,215,0.5065358379653715,Dovish
돈줄/NNG;막/VV,8,10,18,0.5216241395217869,Dovish
실물/NNG;경제/NNG;안정/NNG,2,31,33,0.0420664628646602,Dovish
글라스/NNG,4,21,25,0.1241962236956635,Dovish
수신자금/NNG,7,10,17,0.4564211220815634,Dovish
주택/NNG;공급/NNG;감소/NNG,30,27,57,0.7244779715580371,Dovish
과도/NNG;우려/NNG,13,14,27,0.6054565905163597,Dovish
신흥국/NNG;통화/NNG;약세/NNG,6,14,20,0.2794415033152429,Dovish
영미/NNG,3,21,24,0.0931471677717476,Dovish
아담/NNG,5,45,50,0.0724477971558037,Dovish
금융채/NNG,546,709,1255,0.5021276096242869,Dovish
여수신/NNG,79,70,149,0.7358626253968064,Dovish
데이/NNG,18,46,64,0.2551422421573957,Dovish
잘라/VV,8,9,17,0.5795823772464298,Dovish
경기민감주/NNG,6,16,22,0.2445113154008375,Dovish
본연/NNG,56,50,106,0.7302737953305015,Dovish
금융기업/NNG,33,81,114,0.2656419229046136,Dovish
이중고/NNG,22,20,42,0.7172331918424568,Dovish
하방/NNG;위험/NNG;크/VV,13,16,29,0.5297745167018147,Dovish
국채/NNG;수익률/NNG;상승/NNG,26,25,51,0.6781113813783228,Dovish
억만장자/NNG,11,13,24,0.551717839878813,Dovish
한계점/NNG,23,28,51,0.5355962146875489,Dovish
고용/NNG;안정/NNG,8,10,18,0.5216241395217869,Dovish
성장기반/NNG,23,25,48,0.5998677604500549,Dovish
노인/NNG,65,75,140,0.5650928178152691,Dovish
파급시차/NNG,15,15,30,0.6520301744022334,Dovish
베스트셀러/NNG,17,30,47,0.3694837654945989,Dovish
행과/NNG,8,18,26,0.2897911886232149,Dovish
최저임금/NNG;인상/NNG,22,22,44,0.6520301744022334,Dovish
보고/NNG,45,68,113,0.4314905565897134,Dovish
미세조정/NNG,14,23,37,0.3968879322448378,Dovish
약물/NNG,17,15,32,0.7389675309891979,Dovish
매회/MAG,2,22,24,0.059275470400203,Dovish
선도/NNG,92,81,173,0.7405774820371048,Dovish
금융경제/NNG,71,136,207,0.3403981057541072,Dovish
재정정책/NNG;확대/NNG,5,13,18,0.2507808363085513,Dovish
매크로/NNG,311,312,623,0.6499403340996622,Dovish
귀족/NNG,9,13,22,0.4514055053553924,Dovish
저성장/NNG,124,162,286,0.4990848248510923,Dovish
아고라/NNG,3,17,20,0.1150641484239235,Dovish
공익/NNG,18,64,82,0.1833834865506281,Dovish
연계금융/NNG,15,14,29,0.6986037582881073,Dovish
순증액/NNG,11,25,36,0.2868932767369827,Dovish
듀레이션/NNG;확대/NNG,10,12,22,0.5433584786685279,Dovish
역전/NNG,362,425,787,0.5553762897261377,Dovish
레이스/NNG,10,13,23,0.5015616726171027,Dovish
시련/NNG,7,11,18,0.4149282928014213,Dovish
의석/NNG,17,22,39,0.5038414984017259,Dovish
opec/NNG,212,189,401,0.7313777617633519,Dovish
잔고/NNG,474,445,919,0.6945220284644015,Dovish
중앙선/NNG,12,14,26,0.5588830066304858,Dovish
신자유주의/NNG,9,8,17,0.7335339462025127,Dovish
재정증권/NNG,8,22,30,0.2371018816008122,Dovish
자녀/NNG,255,298,553,0.5579452834649985,Dovish
너티/NNG,9,8,17,0.7335339462025127,Dovish
세전이익/NNG,16,15,31,0.6954988526957158,Dovish
보간법/NNG,11,12,23,0.5976943265353807,Dovish
중간선거/NNG,13,37,50,0.229091682898082,Dovish
각계/NNG,12,22,34,0.3556528224012182,Dovish
통화승수/NNG,10,16,26,0.4075188590013959,Dovish
트레이드/NNG,134,316,450,0.2764938081325927,Dovish
금리/NNG;상승/NNG;압력/NNG,16,23,39,0.4535862082798146,Dovish
허락/NNG,186,236,422,0.5138881883000654,Dovish
내수기업/NNG,24,34,58,0.4602565936956942,Dovish
고용률/NNG,50,71,121,0.4591761791565024,Dovish
사재기/NNG,15,14,29,0.6986037582881073,Dovish
판단/NNG,3938,3799,7737,0.6758870299541972,Dovish
그랬/VV,29,45,74,0.4201972235036616,Dovish
중소기업/NNG;금융지원/NNG;확대/NNG,1,18,19,0.0362238985779018,Dovish
후회/NNG,8,12,20,0.4346867829348224,Dovish
죽전/NNG,8,11,19,0.4742037632016244,Dovish
파워/NNG,102,99,201,0.6717886645356345,Dovish
미칠지/VV,32,29,61,0.7194815717541888,Dovish
브로드밴드/NNG,8,17,25,0.3068377291304628,Dovish
한정판/NNG,2,34,36,0.0383547161413078,Dovish
공기업/NNG,78,134,212,0.3795399522639866,Dovish
보호무역주의/NNG,80,103,183,0.5064312034192106,Dovish
변동금리방식/NNG,1,22,23,0.0296377352001015,Dovish
신용협동조합/NNG,6,26,32,0.1504685017851308,Dovish
특정지역/NNG,13,18,31,0.4709106815127242,Dovish
년대말/NNG,7,11,18,0.4149282928014213,Dovish
안정/NNG;부정적/VAX,8,14,22,0.3725886710869905,Dovish
비용/NNG;부담/NNG;완화/NNG,18,18,36,0.6520301744022334,Dovish
유동성/NNG;개선/NNG,7,17,24,0.2684830129891549,Dovish
예상/NNG;못하/VX;금리/NNG;상승/NNG,1,20,21,0.0326015087201116,Dovish
미성년자/NNG,9,15,24,0.39121810464134,Dovish
사당/NNG,9,12,21,0.4890226308016751,Dovish
의사결정/NNG,70,78,148,0.5851552847199532,Dovish
우동/NNG,11,24,35,0.2988471632676903,Dovish
긴요/NNG,7,30,37,0.1521403740271878,Dovish
소비/NNG;지출/NNG;증가/NNG,9,10,19,0.5868271569620102,Dovish
과언/NNG,14,17,31,0.5369660259783099,Dovish
석학/NNG,14,21,35,0.4346867829348223,Dovish
번호/NNG,46,118,164,0.2541812544279893,Dovish
혼합형/NNG,359,325,684,0.7202425618781595,Dovish
사채발행/NNG,11,30,41,0.2390777306141522,Dovish
보다/MAG,711,662,1373,0.7002922265860846,Dovish
확정치/NNG,67,76,143,0.5748160748019691,Dovish
바랍니다/VV,472,579,1051,0.5315340972674512,Dovish
총장/NNG,13,12,25,0.7063660222690863,Dovish
바라볼/VV,10,14,24,0.4657358388587382,Dovish
이월/NNG,22,21,43,0.6830792303261494,Dovish
경비/NNG,41,39,80,0.6854676192433736,Dovish
손실/NNG;줄/VV,12,16,28,0.4890226308016751,Dovish
장주/NNG,12,11,23,0.7113056448024364,Dovish
흡수합병/NNG,19,33,52,0.3754113125346193,Dovish
수국/NNG,13,16,29,0.5297745167018147,Dovish
투매/NNG,26,31,57,0.546864017240583,Dovish
획기적으로/MAG,15,15,30,0.6520301744022334,Dovish
현물출자/NNG,10,10,20,0.6520301744022335,Dovish
지급수단/NNG,10,17,27,0.3835471614130785,Dovish
하이일드/NNG,451,389,840,0.7559527214791962,Dovish
번가/NNG,10,12,22,0.5433584786685279,Dovish
실무자/NNG,30,39,69,0.5015616726171026,Dovish
오일/NNG,37,34,71,0.7095622486141953,Dovish
우려/NNG;채권/NNG;금리/NNG;상승/NNG,2,17,19,0.0767094322826157,Dovish
기대/NNG;하락/NNG,11,12,23,0.5976943265353807,Dovish
커버드본드/NNG,71,155,226,0.2986718863390876,Dovish
논하/VV,21,27,48,0.5071345800906261,Dovish
메자닌/NNG,17,15,32,0.7389675309891979,Dovish
대출/NNG;축소/NNG,13,13,26,0.6520301744022335,Dovish
실질가치/NNG,9,14,23,0.4191622549728643,Dovish
우선주의/NNG,9,25,34,0.234730862784804,Dovish
청약증거금/NNG,14,16,30,0.5705264026019543,Dovish
적응/NNG,37,49,86,0.4923493153649518,Dovish
조달액/NNG,8,12,20,0.4346867829348224,Dovish
난민/NNG,8,27,35,0.1931941257488099,Dovish
연체/NNG;늘/VV,19,18,37,0.6882540729801354,Dovish
노년층/NNG,26,27,53,0.6278809086836322,Dovish
진심/NNG,35,102,137,0.2237358441576291,Dovish
다지/VV,55,52,107,0.6896472998485162,Dovish
주식선물/NNG,9,11,20,0.5334792336018274,Dovish
위험/NNG;성장/NNG,2,15,17,0.0869373565869644,Dovish
마인드/NNG,7,14,21,0.3260150872011167,Dovish
액션/NNG,17,19,36,0.5833954192019984,Dovish
콜센터/NNG,13,29,42,0.2922893885251392,Dovish
메디컬/NNG,8,10,18,0.5216241395217869,Dovish
만날/VV,13,12,25,0.7063660222690863,Dovish
차주/NNG,581,586,1167,0.646466777009723,Dovish
버튼/NNG,11,11,22,0.6520301744022334,Dovish
제로금리/NNG,30,89,119,0.2197854520456966,Dovish
한도/NNG,993,1158,2151,0.5591243205366303,Dovish
갈아탈/VV,28,117,145,0.1560414092586541,Dovish
실업/NNG,73,67,140,0.7104209362890007,Dovish
승부수/NNG,12,14,26,0.5588830066304858,Dovish
리볼빙/NNG,35,47,82,0.4855543851931526,Dovish
강구/NNG,102,91,193,0.7308470086706353,Dovish
주의깊/VA,11,16,27,0.4482707449015355,Dovish
한글/NNG,11,14,25,0.512309422744612,Dovish
불확실성/NNG;위험/NNG,8,10,18,0.5216241395217869,Dovish
인플레이션/NNG;전망/NNG;불확실성/NNG,3,22,25,0.0889132056003045,Dovish
소비자/NNG;심리/NNG;지수/NNG;하락/NNG,11,14,25,0.512309422744612,Dovish
주택담보대출/NNG,2220,2138,4358,0.6770378798750974,Dovish
기통/NNG,23,39,62,0.3845306156731121,Dovish
누증/NNG,28,26,54,0.7021863416639438,Dovish
정과/NNG,5,12,17,0.2716792393342639,Dovish
대출자금/NNG,11,12,23,0.5976943265353807,Dovish
금리/NNG;상승/NNG;견인/NNG,9,9,18,0.6520301744022334,Dovish
재무활동/NNG,5,13,18,0.2507808363085513,Dovish
지방채/NNG,210,324,534,0.4226121500755217,Dovish
연체율/NNG;뛰/VV,20,27,47,0.4829853143720248,Dovish
평생/NNG,20,22,42,0.5927547040020305,Dovish
소비/NNG;호조/NNG,9,8,17,0.7335339462025127,Dovish
채우/VV,78,84,162,0.6054565905163597,Dovish
이관/NNG,13,17,30,0.4986113098370021,Dovish
상호신용금고/NNG,7,11,18,0.4149282928014213,Dovish
저작물/NNG,72,91,163,0.5158920061204485,Dovish
예상/NNG;달리/MAG;금리/NNG;인하/NNG,4,23,27,0.1133965520699536,Dovish
예정일/NNG,36,42,78,0.5588830066304858,Dovish
가계부/NNG,20,20,40,0.6520301744022335,Dovish
손절/NNG,61,55,116,0.7231607388824771,Dovish
투자심리/NNG;긍정적/VAX,17,19,36,0.5833954192019984,Dovish
반색/NNG,6,11,17,0.3556528224012182,Dovish
일중/NNG,23,32,55,0.4686466878516053,Dovish
물가/NNG;하락/NNG;압력/NNG,7,16,23,0.2852632013009771,Dovish
무단/NNG,341,434,775,0.512309422744612,Dovish
원안/NNG,9,15,24,0.39121810464134,Dovish
국향/NNG,15,20,35,0.4890226308016751,Dovish
추경/NNG,288,339,627,0.5539371393151719,Dovish
원화/NNG;급락/NNG,18,18,36,0.6520301744022334,Dovish
근저당권/NNG,8,16,24,0.3260150872011167,Dovish
포워드가이던스/NNG,45,78,123,0.376171254462827,Dovish
수취/NNG,57,49,106,0.7584840804270879,Dovish
페이스/NNG,14,14,28,0.6520301744022334,Dovish
월전/NNG,12,22,34,0.3556528224012182,Dovish
민간/NNG;부채/NNG;위험/NNG,1,19,20,0.0343173776001175,Dovish
키워야/VV,10,9,19,0.7244779715580372,Dovish
업황/NNG;상승/NNG,7,12,19,0.3803509350679695,Dovish
문동/NNG,3,17,20,0.1150641484239235,Dovish
금리/NNG;밑돌/VV,9,18,27,0.3260150872011167,Dovish
진영/NNG,21,21,42,0.6520301744022335,Dovish
종목명/NNG,110,156,266,0.4597648665656775,Dovish
모집공고/NNG,39,44,83,0.5779358364019797,Dovish
주세/NNG,15,19,34,0.5147606640017633,Dovish
공회/NNG,3,17,20,0.1150641484239235,Dovish
수요/NNG;악화/NNG,9,17,26,0.3451924452717707,Dovish
표면금리/NNG,70,195,265,0.2340621138879812,Dovish
금리/NNG;상승/NNG;제한/NNG,18,24,42,0.4890226308016751,Dovish
국금/NNG,11,10,21,0.7172331918424568,Dovish
변했/VV,21,20,41,0.6846316831223452,Dovish
비례/NNG,44,41,85,0.6997396993584944,Dovish
내정자/NNG,5,22,27,0.1481886760005076,Dovish
수신증/NNG,136,182,318,0.4872313391137569,Dovish
경탁/NNG,19,33,52,0.3754113125346193,Dovish
연회비/NNG,29,38,67,0.4976019752017045,Dovish
장후반/NNG,54,62,116,0.567897248672913,Dovish
회사채/NNG;스프레드/NNG;축소/NNG,8,19,27,0.2745390208009404,Dovish
유로스톡스50/NNG,6,26,32,0.1504685017851308,Dovish
거시정책/NNG,83,85,168,0.6366882879457103,Dovish
핵심역량/NNG,8,10,18,0.5216241395217869,Dovish
봉차트/NNG,3,14,17,0.1397207516576214,Dovish
자금흐름/NNG,150,210,360,0.4657358388587382,Dovish
고교/NNG,9,9,18,0.6520301744022334,Dovish
자문위원/NNG,12,26,38,0.3009370035702616,Dovish
일로/NNG,16,23,39,0.4535862082798146,Dovish
감정평가액/NNG,9,8,17,0.7335339462025127,Dovish
감액/NNG,31,90,121,0.2245881711829915,Dovish
반대표/NNG,13,12,25,0.7063660222690863,Dovish
칭했/VV,3,14,17,0.1397207516576214,Dovish
몰이/NNG,11,19,30,0.3774911536012931,Dovish
식당/NNG,79,72,151,0.7154219969135617,Dovish
수리/NNG,43,50,93,0.5607459499859208,Dovish
한해/VV,7,27,34,0.1690448600302086,Dovish
바라본/VV,22,23,45,0.623681036384745,Dovish
하이퍼인플레이션/NNG,8,18,26,0.2897911886232149,Dovish
변하/VV,165,166,331,0.6481022817853525,Dovish
국외/NNG,41,49,90,0.545576268377379,Dovish
주주사/NNG,7,11,18,0.4149282928014213,Dovish
만기별/NNG,182,184,366,0.6449428898978614,Dovish
추억/NNG,9,8,17,0.7335339462025127,Dovish
금리/NNG;상회/NNG,10,10,20,0.6520301744022335,Dovish
신고가종목/NNG,3,15,18,0.1304060348804467,Dovish
힘써/VV,16,27,43,0.3863882514976198,Dovish
격비/NNG,16,23,39,0.4535862082798146,Dovish
자본/NNG;규제/NNG;강화/NNG,2,17,19,0.0767094322826157,Dovish
약하/VA;금리/NNG;인하/NNG,13,12,25,0.7063660222690863,Dovish
대표기업/NNG,24,24,48,0.6520301744022334,Dovish
신용등급/NNG;하락/NNG,22,26,48,0.551717839878813,Dovish
분자/NNG,7,14,21,0.3260150872011167,Dovish
기대/NNG;인플레이션/NNG;높/VA,13,14,27,0.6054565905163597,Dovish
우측/NNG,8,29,37,0.1798703929385472,Dovish
우량등급/NNG,130,210,340,0.4036377270109064,Dovish
재정위기/NNG,143,192,335,0.4856266403099968,Dovish
보유자산/NNG,61,84,145,0.4734981028397172,Dovish
아메리칸/NNG,12,17,29,0.4602565936956942,Dovish
소매/NNG;판매/NNG;호조/NNG,4,19,23,0.1372695104004702,Dovish
인플레이션/NNG;꺾/VV,10,17,27,0.3835471614130785,Dovish
취소/NNG,148,132,280,0.7310641349358376,Dovish
선반/NNG,9,14,23,0.4191622549728643,Dovish
환차손/NNG;위험/NNG,8,13,21,0.4012493380936822,Dovish
내야/NNG,17,16,33,0.6927820603023731,Dovish
엔지니어링/NNG,31,31,62,0.6520301744022335,Dovish
경영전략회의/NNG,2,25,27,0.0521624139521786,Dovish
디레버리징/NNG,56,102,158,0.3579773506522066,Dovish
경제/NNG;낙관/NNG,3,14,17,0.1397207516576214,Dovish
금융시장/NNG;충격/NNG,6,13,19,0.3009370035702616,Dovish
좁혀졌/VV,43,47,90,0.5965382446658732,Dovish
공짜/NNG,14,32,46,0.2852632013009771,Dovish
금리/NNG;인하/NNG;가능성/NNG;약화/NNG,4,16,20,0.1630075436005583,Dovish
다소간/MAG,19,21,40,0.5899320625544018,Dovish
의외/NNG,25,22,47,0.740943380002538,Dovish
가해/VV,8,14,22,0.3725886710869905,Dovish
국고채/NNG;금리/NNG;하락/NNG;금리/NNG;하락/NNG,1,26,27,0.0250780836308551,Dovish
우하향/NNG,8,9,17,0.5795823772464298,Dovish
헤지펀드/NNG,83,85,168,0.6366882879457103,Dovish
글로벌/NNG;금융시장/NNG;변동성/NNG;확대/NNG,8,31,39,0.1682658514586409,Dovish
오퍼레이션트위스트/NNG,7,20,27,0.2282105610407817,Dovish
보름/NNG,24,44,68,0.3556528224012182,Dovish
챌린지/NNG,96,174,270,0.3597407858770943,Dovish
서머랠리/NNG,8,13,21,0.4012493380936822,Dovish
리가/NNG,8,12,20,0.4346867829348224,Dovish
틱스/NNG,14,18,32,0.5071345800906261,Dovish
성별/NNG,8,9,17,0.5795823772464298,Dovish
인텔리/NNG,9,11,20,0.5334792336018274,Dovish
발권력/NNG,1,24,25,0.0271679239334264,Dovish
일일이/MAG,12,12,24,0.6520301744022334,Dovish
선수촌/NNG,8,12,20,0.4346867829348224,Dovish
기여율/NNG,5,12,17,0.2716792393342639,Dovish
당정/NNG,10,16,26,0.4075188590013959,Dovish
규율/NNG,5,15,20,0.2173433914674111,Dovish
교훈/NNG,11,15,26,0.4781554612283045,Dovish
초당/NNG,18,43,61,0.2729428637032605,Dovish
바스켓/NNG,13,14,27,0.6054565905163597,Dovish
심리/NNG;위축/NNG,19,17,36,0.7287396066848493,Dovish
진공/NNG,192,193,385,0.6486517797162115,Dovish
경제/NNG;안정/NNG,18,16,34,0.7335339462025127,Dovish
중금채/NNG,30,40,70,0.4890226308016751,Dovish
틀렸/VV,13,14,27,0.6054565905163597,Dovish
제공업체/NNG,22,31,53,0.4627310915112624,Dovish
부채총계/NNG,15,27,42,0.3622389857790185,Dovish
채워/VV,21,27,48,0.5071345800906261,Dovish
말소/NNG,10,23,33,0.2834913801748841,Dovish
단위/NNG,854,877,1731,0.6349301812309093,Dovish
법인세중간예납/NNG,8,12,20,0.4346867829348224,Dovish
글로벌/NNG;경기/NNG;개선/NNG,13,28,41,0.3027282952581798,Dovish
최대/NNG;하락/NNG,17,18,35,0.6158062758243317,Dovish
양적완화/NNG,243,496,739,0.3194422023785136,Dovish
규제비율/NNG,42,65,107,0.4213118049983663,Dovish
미약/NNG,124,192,316,0.4211028209681091,Dovish
캐피탈채/NNG,242,268,510,0.5887735156915691,Dovish
가수요/NNG,21,25,46,0.5477053464978762,Dovish
스몰딜/NNG,8,9,17,0.5795823772464298,Dovish
부동산/NNG;경기/NNG;악화/NNG,20,28,48,0.4657358388587382,Dovish
기를/VV,13,12,25,0.7063660222690863,Dovish
환경보호/NNG,8,12,20,0.4346867829348224,Dovish
연설자/NNG,8,11,19,0.4742037632016244,Dovish
바이/MAG,16,18,34,0.5795823772464298,Dovish
가까스로/MAG,19,19,38,0.6520301744022335,Dovish
경제/NNG;최대/NNG,12,12,24,0.6520301744022334,Dovish
도표/NNG,224,504,728,0.2897911886232149,Dovish
이바지/NNG,13,13,26,0.6520301744022335,Dovish
인하/NNG;금리/NNG;인하/NNG,8,10,18,0.5216241395217869,Dovish
기관경고/NNG,3,29,32,0.0674513973519551,Dovish
동일등급/NNG,15,27,42,0.3622389857790185,Dovish
어쩌면/MAG,48,46,94,0.6803793124197218,Dovish
에이스/NNG,33,45,78,0.4781554612283045,Dovish
변형/NNG,73,94,167,0.5063638588442877,Dovish
교역/NNG,312,292,604,0.6966897753886878,Dovish
노벨경제학상/NNG,11,13,24,0.551717839878813,Dovish
탕감/NNG,19,18,37,0.6882540729801354,Dovish
통화정책방향문/NNG,9,11,20,0.5334792336018274,Dovish
변명/NNG,15,26,41,0.376171254462827,Dovish
순상환/NNG,122,143,265,0.5562774914480594,Dovish
고용/NNG;개선/NNG,18,19,37,0.617712796802116,Dovish
블라인드/NNG,12,11,23,0.7113056448024364,Dovish
똘똘/NNG,50,43,93,0.7581746213979459,Dovish
저축성/NNG,365,403,768,0.5905484209846531,Dovish
장기영역/NNG,48,44,92,0.7113056448024364,Dovish
듀레이션/NNG;길/VA,15,24,39,0.4075188590013959,Dovish
에프/NNG,94,162,256,0.3783384962580861,Dovish
민자발전/NNG,1,19,20,0.0343173776001175,Dovish
테이퍼링/NNG,43,62,105,0.4522144757950974,Dovish
자율협약/NNG,3,14,17,0.1397207516576214,Dovish
담보/NNG,391,356,747,0.7161342645822283,Dovish
추이/NNG,1764,2414,4178,0.4764628117835707,Dovish
상장폐지/NNG,33,36,69,0.5976943265353807,Dovish
가계/NNG;부담/NNG,15,18,33,0.5433584786685278,Dovish
유종/NNG,8,11,19,0.4742037632016244,Dovish
현금/NNG,641,726,1367,0.575690553432275,Dovish
허위/NNG,19,18,37,0.6882540729801354,Dovish
프로세스/NNG,60,62,122,0.6309969429699034,Dovish
버터플라이/NNG,9,9,18,0.6520301744022334,Dovish
달달/MAG,21,51,72,0.268483012989155,Dovish
투자/NNG;매력/NNG;높/VA,24,23,47,0.6803793124197218,Dovish
기간조정/NNG,11,25,36,0.2868932767369827,Dovish
엠파이어스테이트/NNG,16,24,40,0.4346867829348224,Dovish
원한다면/VV,9,9,18,0.6520301744022334,Dovish
취업/NNG,104,113,217,0.6000985675914361,Dovish
금리/NNG;인하/NNG;그치/VV,19,25,44,0.4955429325456975,Dovish
융통/NNG,30,28,58,0.6986037582881073,Dovish
인하/NNG;줄/VV,15,19,34,0.5147606640017633,Dovish
문서/NNG,15,18,33,0.5433584786685278,Dovish
정립/NNG,21,26,47,0.5266397562479579,Dovish
초회/NNG,5,18,23,0.1811194928895093,Dovish
분명/NNG,12,18,30,0.4346867829348222,Dovish
수출/NNG;상승/NNG,9,8,17,0.7335339462025127,Dovish
인구증가/NNG,5,16,21,0.2037594295006979,Dovish
상이/NNG,52,65,117,0.5216241395217868,Dovish
중위소득/NNG,11,10,21,0.7172331918424568,Dovish
순유출/NNG,173,173,346,0.6520301744022335,Dovish
주담/NNG,12,31,43,0.2523987771879613,Dovish
불평등/NNG,34,49,83,0.4524291006056314,Dovish
편드/VV,11,14,25,0.512309422744612,Dovish
창의/NNG,11,12,23,0.5976943265353807,Dovish
실버타운/NNG,20,21,41,0.6209811184783176,Dovish
무작위/NNG,10,9,19,0.7244779715580372,Dovish
라스/NNG,5,18,23,0.1811194928895093,Dovish
가나/NNG,10,13,23,0.5015616726171027,Dovish
수익증권/NNG;증가/NNG,10,22,32,0.2963773520010152,Dovish
가난/NNG,11,10,21,0.7172331918424568,Dovish
마비/NNG,5,12,17,0.2716792393342639,Dovish
양질/NNG,43,46,89,0.6095064673760009,Dovish
구조조정/NNG,782,765,1547,0.6665197338333942,Dovish
휴사/NNG,35,47,82,0.4855543851931526,Dovish
금리/NNG;안정/NNG,35,39,74,0.5851552847199532,Dovish
화려/NNG,10,19,29,0.3431737760011755,Dovish
뒤흔들/VV,9,9,18,0.6520301744022334,Dovish
대점/NNG,7,11,18,0.4149282928014213,Dovish
투자대상/NNG,61,78,139,0.5099210338273877,Dovish
상설/NNG,13,18,31,0.4709106815127242,Dovish
소위/NNG,47,47,94,0.6520301744022334,Dovish
실거/NNG,13,18,31,0.4709106815127242,Dovish
길동/NNG,15,21,36,0.4657358388587382,Dovish
기채/NNG,14,13,27,0.7021863416639438,Dovish
아마/MAG,59,56,115,0.6869603623166388,Dovish
대출/NNG;많/VA,12,11,23,0.7113056448024364,Dovish
국채/NNG,5666,6546,12212,0.5643756443878788,Dovish
중간/NNG,217,192,409,0.7369299366941909,Dovish
db/NNG,248,408,656,0.3963320667935144,Dovish
상단/NNG,501,461,962,0.708605460684423,Dovish
아기/NNG,10,9,19,0.7244779715580372,Dovish
도덕적해이/NNG,26,29,55,0.5845787770502784,Dovish
편취/NNG,9,8,17,0.7335339462025127,Dovish
등급평가/NNG,5,13,18,0.2507808363085513,Dovish
황원/NNG,4,116,120,0.0224837991173184,Dovish
제철/NNG,11,10,21,0.7172331918424568,Dovish
연체액/NNG,87,99,186,0.5729962138686294,Dovish
실적/NNG;증가/NNG,15,20,35,0.4890226308016751,Dovish
녹색/NNG,54,59,113,0.5967733799613663,Dovish
관행/NNG,97,93,190,0.6800744829786738,Dovish
범어/NNG,18,24,42,0.4890226308016751,Dovish
신종자본증권/NNG,203,185,388,0.7154709481278562,Dovish
무보증사채/NNG,24,35,59,0.4471064053043886,Dovish
오디오/NNG,8,10,18,0.5216241395217869,Dovish
수여/NNG,15,23,38,0.4252370702623262,Dovish
경제활동인구/NNG,17,16,33,0.6927820603023731,Dovish
연사/NNG,15,17,32,0.5753207421196178,Dovish
링깃/NNG,8,25,33,0.2086496558087147,Dovish
자금난/NNG,52,78,130,0.4346867829348223,Dovish
비즈니스모델/NNG,25,25,50,0.6520301744022334,Dovish
채권펀드/NNG,177,242,419,0.4768981027652699,Dovish
밝힘/VV,36,48,84,0.4890226308016751,Dovish
완전/NNG,637,600,1237,0.6922387018237046,Dovish
경제/NNG;악화/NNG,6,12,18,0.3260150872011167,Dovish
국채입찰/NNG;수요/NNG;부진/NNG,3,32,35,0.0611278288502093,Dovish
초전도체/NNG,10,9,19,0.7244779715580372,Dovish
미시/NNG,78,68,146,0.7479169647555032,Dovish
러셀지수/NNG,10,26,36,0.2507808363085513,Dovish
유럽의회/NNG,32,43,75,0.4852317576946854,Dovish
누그러뜨렸/VV,4,18,22,0.1448955943116074,Dovish
방한/NNG,51,58,109,0.5733368774916191,Dovish
마이너스통장대출/NNG,9,11,20,0.5334792336018274,Dovish
전망/NNG;강세/NNG,4,16,20,0.1630075436005583,Dovish
안심/NNG,192,180,372,0.6954988526957157,Dovish
브레턴우즈체제/NNG,4,18,22,0.1448955943116074,Dovish
은행업계/NNG,61,68,129,0.5849094211549448,Dovish
사임/NNG,15,40,55,0.2445113154008375,Dovish
상환권/NNG,8,12,20,0.4346867829348224,Dovish
미트/NNG,8,13,21,0.4012493380936822,Dovish
계량모형/NNG,6,11,17,0.3556528224012182,Dovish
신용등급/NNG;전망/NNG;안정/NNG;부정적/VAX;하향/NNG,15,15,30,0.6520301744022334,Dovish
임대사업자/NNG,25,29,54,0.5620949779329599,Dovish
휘청이/VV,15,16,31,0.6112782885020939,Dovish
건설공제조합/NNG,13,17,30,0.4986113098370021,Dovish
생물/NNG,11,11,22,0.6520301744022334,Dovish
경기/NNG;침체/NNG;위험/NNG,10,11,21,0.5927547040020305,Dovish
간별/NNG,17,28,45,0.3958754630299275,Dovish
다층/NNG,9,8,17,0.7335339462025127,Dovish
사회공헌활동/NNG,31,130,161,0.1554841185113018,Dovish
오피스텔/NNG,500,440,940,0.740943380002538,Dovish
인플레이션/NNG;경계/NNG,18,29,47,0.4047083841117311,Dovish
aa등급/NNG,84,99,183,0.5532377237352284,Dovish
순발행금액/NNG,32,31,63,0.6730634058345637,Dovish
다발/NNG,9,22,31,0.2667396168009137,Dovish
수익증권/NNG,61,113,174,0.3519808906065154,Dovish
인지세/NNG,6,24,30,0.1630075436005583,Dovish
요금/NNG;인하/NNG,9,8,17,0.7335339462025127,Dovish
미온/NNG,15,14,29,0.6986037582881073,Dovish
비상시/NNG,10,14,24,0.4657358388587382,Dovish
채도/NNG,5,12,17,0.2716792393342639,Dovish
독일채/NNG,12,27,39,0.2897911886232148,Dovish
가져야/VV,32,33,65,0.6322716842688325,Dovish
개별기업/NNG,50,51,101,0.6392452690217976,Dovish
언니/NNG,9,12,21,0.4890226308016751,Dovish
돌아와/VV,12,14,26,0.5588830066304858,Dovish
전후/NNG,231,209,440,0.7206649296024686,Dovish
단체장/NNG,6,11,17,0.3556528224012182,Dovish
주식담보대출/NNG,26,28,54,0.6054565905163597,Dovish
궤적/NNG,20,25,45,0.5216241395217868,Dovish
부채비율/NNG;상승/NNG,9,10,19,0.5868271569620102,Dovish
작성자/NNG,105,172,277,0.3980416762339216,Dovish
중시/NNG,95,86,181,0.7202658903280487,Dovish
소비자/NNG;물가/NNG;상승률/NNG;낮/VA,11,13,24,0.551717839878813,Dovish
좌파/NNG,10,30,40,0.2173433914674111,Dovish
변할/VV,19,20,39,0.6194286656821218,Dovish
수출국/NNG,44,80,124,0.3586165959212284,Dovish
콘셉트/NNG,22,20,42,0.7172331918424568,Dovish
안정국면/NNG,16,25,41,0.4172993116174294,Dovish
계열회사/NNG,54,71,125,0.4959102734890226,Dovish
상환액/NNG,40,73,113,0.3572768078916348,Dovish
옛날/NNG,15,17,32,0.5753207421196178,Dovish
발표자/NNG,16,17,33,0.6136754582609257,Dovish
철저히/MAG,88,82,170,0.6997396993584944,Dovish
상급/NNG,22,47,69,0.3052056135499816,Dovish
과대평가/NNG,17,19,36,0.5833954192019984,Dovish
금리/NNG;급락/NNG,25,26,51,0.6269520907713784,Dovish
내연/NNG,9,11,20,0.5334792336018274,Dovish
빈도/NNG,30,27,57,0.7244779715580371,Dovish
신용잔고/NNG,11,17,28,0.4219018775543863,Dovish
볼커룰/NNG,12,11,23,0.7113056448024364,Dovish
화합/NNG,13,31,44,0.2734320086202915,Dovish
진행자/NNG,2,91,93,0.0143303335033457,Dovish
경직/NNG,146,147,293,0.6475945949845312,Dovish
주택/NNG;거래/NNG;증가/NNG,12,30,42,0.2608120697608934,Dovish
기대수명/NNG,3,75,78,0.0260812069760893,Dovish
국제/NNG;금융시장/NNG;불안/NNG,9,10,19,0.5868271569620102,Dovish
역효과/NNG,11,10,21,0.7172331918424568,Dovish
자산/NNG;증가/NNG,20,25,45,0.5216241395217868,Dovish
환매수/NNG,17,19,36,0.5833954192019984,Dovish
금리/NNG;인하/NNG;금리/NNG;인하/NNG,16,17,33,0.6136754582609257,Dovish
소비자/NNG;물가/NNG;상승률/NNG;물가/NNG;안정/NNG,15,19,34,0.5147606640017633,Dovish
수출/NNG;경기/NNG;회복/NNG,14,20,34,0.4564211220815634,Dovish
가업/NNG,23,23,46,0.6520301744022335,Dovish
공백기/NNG,17,25,42,0.4433805185935188,Dovish
육상/NNG,22,23,45,0.623681036384745,Dovish
월세/NNG,387,434,821,0.5814186117365538,Dovish
트래픽/NNG,14,35,49,0.2608120697608934,Dovish
대출/NNG;금리/NNG;높/VA,11,13,24,0.551717839878813,Dovish
예상/NNG;상승/NNG;밑돌/VV,3,15,18,0.1304060348804467,Dovish
비상계획/NNG,8,12,20,0.4346867829348224,Dovish
국은/NNG,8,9,17,0.5795823772464298,Dovish
주미/NNG,1,18,19,0.0362238985779018,Dovish
체크카드/NNG,111,175,286,0.4135734249065595,Dovish
수임/NNG,7,17,24,0.2684830129891549,Dovish
건전성/NNG;지표/NNG;악화/NNG,16,20,36,0.5216241395217869,Dovish
기대/NNG;충족/NNG,14,14,28,0.6520301744022334,Dovish
물가/NNG;하향/NNG,11,12,23,0.5976943265353807,Dovish
우량/NNG,341,310,651,0.7172331918424568,Dovish
반려/NNG,13,13,26,0.6520301744022335,Dovish
원리금/NNG;부담/NNG,5,23,28,0.141745690087442,Dovish
미국식/NNG,4,16,20,0.1630075436005583,Dovish
민감히/MAG,8,13,21,0.4012493380936822,Dovish
하락/NNG;안정/NNG,10,9,19,0.7244779715580372,Dovish
일시적/VAX;증가/NNG,14,15,29,0.6085614961087512,Dovish
마포/NNG,40,35,75,0.7451773421739812,Dovish
이어받/VV,31,29,60,0.6969977726368703,Dovish
주택시장/NNG;회복/NNG,43,44,87,0.6372113068021827,Dovish
퍼스트/NNG,47,45,92,0.681009293264555,Dovish
선진국/NNG,778,1225,2003,0.4141056944366838,Dovish
선회/NNG,60,62,122,0.6309969429699034,Dovish
어머니/NNG,10,10,20,0.6520301744022335,Dovish
물가/NNG;상승률/NNG;상승/NNG,11,10,21,0.7172331918424568,Dovish
투수/NNG,26,24,50,0.7063660222690863,Dovish
경제/NNG;개선/NNG,17,24,41,0.4618547068682487,Dovish
국의/NNG,24,22,46,0.7113056448024364,Dovish
소화/NNG,221,204,425,0.7063660222690863,Dovish
고용시장/NNG;강하/VA,12,11,23,0.7113056448024364,Dovish
순매도우위/NNG,7,15,22,0.3042807480543756,Dovish
물가/NNG;상승/NNG;견인/NNG,9,9,18,0.6520301744022334,Dovish
주택건설협회/NNG,18,24,42,0.4890226308016751,Dovish
반작용/NNG,21,33,54,0.4149282928014213,Dovish
준정부기관/NNG,8,14,22,0.3725886710869905,Dovish
미정/NNG,11,11,22,0.6520301744022334,Dovish
다면/NNG,39,50,89,0.5085835360337421,Dovish
완만/NNG;경기/NNG;회복/NNG,5,14,19,0.2328679194293691,Dovish
부작용/NNG,237,242,479,0.6385584765840056,Dovish
매도헤지/NNG,10,13,23,0.5015616726171027,Dovish
opec/NNG;감산/NNG,28,31,59,0.5889304801052432,Dovish
대부업/NNG,167,360,527,0.3024695531254805,Dovish
작성/NNG,631,593,1224,0.6938128837231186,Dovish
관행개선/NNG,5,16,21,0.2037594295006979,Dovish
핵무기/NNG,10,16,26,0.4075188590013959,Dovish
멀티플/NNG,10,9,19,0.7244779715580372,Dovish
예상/NNG;미루/VV,9,8,17,0.7335339462025127,Dovish
정확/VAX,95,83,178,0.7462995972073756,Dovish
척도/NNG,19,18,37,0.6882540729801354,Dovish
원선/NNG,112,132,244,0.5532377237352284,Dovish
고용자수/NNG;증가/NNG,31,28,59,0.7218905502310442,Dovish
지정학/NNG;긴장/NNG;완화/NNG,6,13,19,0.3009370035702616,Dovish
매운맛/NNG,5,32,37,0.1018797147503489,Dovish
인터넷은행/NNG,415,376,791,0.7196609637684226,Dovish
상장예비심사/NNG,9,21,30,0.2794415033152429,Dovish
반사/NNG,24,28,52,0.5588830066304858,Dovish
출로/NNG,18,24,42,0.4890226308016751,Dovish
오염/NNG,11,27,38,0.2656419229046136,Dovish
한해서/VV,17,16,33,0.6927820603023731,Dovish
연금액/NNG,8,15,23,0.3477494263478579,Dovish
기금/NNG,799,865,1664,0.6022798951992885,Dovish
도인/NNG,9,11,20,0.5334792336018274,Dovish
경기민감업종/NNG,9,52,61,0.1128513763388481,Dovish
취업자/NNG,128,113,241,0.738582852420229,Dovish
거액/NNG,40,40,80,0.6520301744022335,Dovish
가계/NNG;부채/NNG;증가/NNG,50,69,119,0.4724856336248069,Dovish
목표일/NNG,2,24,26,0.0543358478668528,Dovish
혼합/NNG,199,323,522,0.4017151848484348,Dovish
안녕/NNG,25,33,58,0.4939622533350253,Dovish
미채권/NNG,14,27,41,0.3380897200604173,Dovish
하락/NNG;효과/NNG,19,17,36,0.7287396066848493,Dovish
트래블/NNG,142,169,311,0.5478596731663737,Dovish
기타법인/NNG,105,186,291,0.368081550065777,Dovish
실입주/NNG,6,13,19,0.3009370035702616,Dovish
ftse/NNG,158,204,362,0.50500376252722,Dovish
상환기금채/NNG,7,11,18,0.4149282928014213,Dovish
불확실성/NNG;증대/NNG,25,29,54,0.5620949779329599,Dovish
단기물/NNG;금리/NNG;상승/NNG,9,8,17,0.7335339462025127,Dovish
매주/NNG,86,84,170,0.6675547023641915,Dovish
출하비율/NNG,18,16,34,0.7335339462025127,Dovish
결정문/NNG,42,44,86,0.622392439202132,Dovish
미주/NNG,26,38,64,0.4461259088015282,Dovish
배포/NNG,480,575,1055,0.5443034499357775,Dovish
나노공정/NNG,9,10,19,0.5868271569620102,Dovish
희생/NNG,13,19,32,0.4461259088015282,Dovish
사업자금/NNG,20,19,39,0.6863475520023511,Dovish
주봉/NNG,16,20,36,0.5216241395217869,Dovish
동태/NNG,8,9,17,0.5795823772464298,Dovish
대조표/NNG,5,12,17,0.2716792393342639,Dovish
인쇄/NNG,6,12,18,0.3260150872011167,Dovish
변동/NNG,2813,2603,5416,0.7046334539352604,Dovish
포워드/NNG,11,43,54,0.1667984167075481,Dovish
상세히/MAG,19,17,36,0.7287396066848493,Dovish
時差/NNG,1,26,27,0.0250780836308551,Dovish
연고점/NNG;높/VV,4,17,21,0.1534188645652314,Dovish
위조/NNG,8,9,17,0.5795823772464298,Dovish
준거/NNG,40,70,110,0.3725886710869906,Dovish
온건/NNG,7,10,17,0.4564211220815634,Dovish
특이/NNG,33,60,93,0.3586165959212284,Dovish
심도/NNG,6,18,24,0.2173433914674111,Dovish
유동성/NNG;높/VA,20,19,39,0.6863475520023511,Dovish
전망/NNG;성장/NNG,8,12,20,0.4346867829348224,Dovish
자기자본비율/NNG,78,103,181,0.4937704233337302,Dovish
dr/NNG,8,24,32,0.2173433914674112,Dovish
대부업법/NNG,10,19,29,0.3431737760011755,Dovish
기준등급/NNG,10,19,29,0.3431737760011755,Dovish
자금시장/NNG,78,93,171,0.546864017240583,Dovish
예하/NNG,44,42,86,0.6830792303261494,Dovish
대처/NNG,95,89,184,0.6959872648113727,Dovish
경제/NNG;부정적/VAX,12,12,24,0.6520301744022334,Dovish
켜진/VV,22,19,41,0.7549823072025862,Dovish
이브/NNG,12,12,24,0.6520301744022334,Dovish
빨리/MAG;금리/NNG;인하/NNG,5,13,18,0.2507808363085513,Dovish
증기/NNG,8,20,28,0.2608120697608934,Dovish
고객자금/NNG,10,27,37,0.2414926571860124,Dovish
망설이/VV,27,26,53,0.6771082580330886,Dovish
항셍지수/NNG,117,123,240,0.6202238244313929,Dovish
신용등급/NNG;전망/NNG;하향/NNG,16,38,54,0.2745390208009404,Dovish
황한/NNG,7,22,29,0.2074641464007106,Dovish
影響/NNG,8,13,21,0.4012493380936822,Dovish
한번/MAG,37,35,72,0.6892890415109326,Dovish
민영화/NNG,11,39,50,0.1839059466262709,Dovish
지급일/NNG,16,20,36,0.5216241395217869,Dovish
주택담보대출/NNG;금리/NNG;내리/VV,13,19,32,0.4461259088015282,Dovish
유휴노동력/NNG,12,15,27,0.5216241395217868,Dovish
다양화/NNG,36,52,88,0.4514055053553924,Dovish
구제금융안/NNG,2,15,17,0.0869373565869644,Dovish
발행/NNG,5191,5412,10603,0.6254044041614919,Dovish
주식비중/NNG,36,61,97,0.3848046930898427,Dovish
일식/NNG,5,28,33,0.1164339597146845,Dovish
연대보증/NNG,47,50,97,0.6129083639380994,Dovish
오버/NNG,43,55,98,0.5097690454417462,Dovish
기평/NNG,201,212,413,0.6181984200700421,Dovish
소방/NNG,8,12,20,0.4346867829348224,Dovish
베이지북/NNG,88,97,185,0.5915325293546035,Dovish
cb/NNG,108,151,259,0.4663527075194782,Dovish
잔존/NNG,135,141,276,0.6242842095340534,Dovish
다진/VV,18,25,43,0.4694617255696081,Dovish
리치/NNG,20,28,48,0.4657358388587382,Dovish
여력/NNG;확대/NNG,9,10,19,0.5868271569620102,Dovish
주택매매/NNG,157,140,297,0.731205267008219,Dovish
대체/NNG,200,187,387,0.6973584752965064,Dovish
행의/NNG,22,28,50,0.512309422744612,Dovish
중상위/NNG,8,13,21,0.4012493380936822,Dovish
올레/NNG,3,16,19,0.1222556577004187,Dovish
공부/NNG,39,34,73,0.7479169647555032,Dovish
끊겼/VV,11,12,23,0.5976943265353807,Dovish
밝혔으며/VV,13,34,47,0.249305654918501,Dovish
수자/NNG,21,19,40,0.7206649296024688,Dovish
폐업/NNG,364,316,680,0.7510727325392816,Dovish
다반사/NNG,9,8,17,0.7335339462025127,Dovish
영세기업/NNG,7,12,19,0.3803509350679695,Dovish
보유기업/NNG,10,20,30,0.3260150872011167,Dovish
체류/NNG,36,37,73,0.6344077372562272,Dovish
꼬박꼬박/MAG,7,11,18,0.4149282928014213,Dovish
수출보험/NNG,7,27,34,0.1690448600302086,Dovish
채권시장/NNG;강세/NNG,55,55,110,0.6520301744022335,Dovish
독신/NNG,3,54,57,0.0362238985779018,Dovish
상존/NNG,264,274,538,0.6282334527087212,Dovish
언더/NNG,31,39,70,0.5182803950376728,Dovish
떼일/VV,7,16,23,0.2852632013009771,Dovish
놀이터/NNG,13,48,61,0.1765915055672715,Dovish
다양/NNG;위험/NNG,12,19,31,0.4118085312014106,Dovish
흘러들/VV,9,8,17,0.7335339462025127,Dovish
납입금/NNG,44,45,89,0.6375406149710727,Dovish
수출/NNG;가격/NNG;개선/NNG,6,16,22,0.2445113154008375,Dovish
구제금융/NNG,46,131,177,0.2289571604771201,Dovish
유로엔/NNG,10,9,19,0.7244779715580372,Dovish
경제주체/NNG;심리/NNG;위축/NNG,5,14,19,0.2328679194293691,Dovish
옮겨간/VV,10,16,26,0.4075188590013959,Dovish
상충관계/NNG,5,15,20,0.2173433914674111,Dovish
자산/NNG;가격/NNG;거품/NNG,10,9,19,0.7244779715580372,Dovish
돌아보/VV,17,20,37,0.5542256482418985,Dovish
전망/NNG;강화/NNG,16,16,32,0.6520301744022335,Dovish
차분/NNG,14,19,33,0.4804432864016457,Dovish
스프레드/NNG,4532,5266,9798,0.5611471231277863,Dovish
소지자/NNG,2,17,19,0.0767094322826157,Dovish
하락룸/NNG,16,20,36,0.5216241395217869,Dovish
지준일/NNG,15,16,31,0.6112782885020939,Dovish
소계/NNG,10,11,21,0.5927547040020305,Dovish
준다고/VV,10,10,20,0.6520301744022335,Dovish
소스/NNG,11,12,23,0.5976943265353807,Dovish
전망/NNG;불확실/NNG,9,8,17,0.7335339462025127,Dovish
예상밖/NNG;부진/NNG,7,11,18,0.4149282928014213,Dovish
채권/NNG;금리/NNG;하향/NNG;안정/NNG,9,17,26,0.3451924452717707,Dovish
경제/NNG;지표/NNG;악화/NNG,13,28,41,0.3027282952581798,Dovish
순응/NNG,10,10,20,0.6520301744022335,Dovish
지적재산권/NNG,189,250,439,0.4929348118480884,Dovish
대외/NNG,1138,984,2122,0.7540755472253473,Dovish
금융시스템/NNG,71,73,144,0.6341663340076518,Dovish
따라서/VV,242,244,486,0.6466856647759857,Dovish
수요/NNG;확보/NNG,28,27,55,0.6761794401208346,Dovish
정규/NNG,29,25,54,0.7563550023065909,Dovish
공동체/NNG,11,11,22,0.6520301744022334,Dovish
금리/NNG;하회/NNG,12,18,30,0.4346867829348222,Dovish
데스/NNG,14,15,29,0.6085614961087512,Dovish
펀더멘털/NNG;개선/NNG,23,33,56,0.4544452730682233,Dovish
경향/NNG,362,327,689,0.7218193368000261,Dovish
페소/NNG,97,227,324,0.2786208234229809,Dovish
스케줄/NNG,25,23,48,0.7087284504372103,Dovish
공급측면/NNG,92,95,187,0.631439747842163,Dovish
예상/NNG;성장/NNG,8,13,21,0.4012493380936822,Dovish
기업/NNG;환경/NNG;개선/NNG,6,14,20,0.2794415033152429,Dovish
디플레이션/NNG,200,325,525,0.4012493380936821,Dovish
합성etf/NNG,62,93,155,0.4346867829348224,Dovish
마두/NNG,6,11,17,0.3556528224012182,Dovish
시발점/NNG,5,15,20,0.2173433914674111,Dovish
지표/NNG;하락/NNG,15,20,35,0.4890226308016751,Dovish
도모/NNG,109,102,211,0.6967773432337594,Dovish
빨리/MAG,293,318,611,0.6007699405655799,Dovish
고금리/NNG;이자/NNG;부담/NNG,9,13,22,0.4514055053553924,Dovish
산업혁명/NNG,14,13,27,0.7021863416639438,Dovish
디폴트/NNG,123,192,315,0.4177068304764308,Dovish
분할상환/NNG,61,64,125,0.6214662599771289,Dovish
업명/NNG,9,11,20,0.5334792336018274,Dovish
찾아올/VV,5,12,17,0.2716792393342639,Dovish
대생/NNG,10,17,27,0.3835471614130785,Dovish
순투자/NNG,40,64,104,0.4075188590013959,Dovish
실생활/NNG,6,16,22,0.2445113154008375,Dovish
글로벌/NNG;금융시장/NNG;불확실성/NNG,9,9,18,0.6520301744022334,Dovish
주입/NNG,3,20,23,0.097804526160335,Dovish
리턴/NNG,29,25,54,0.7563550023065909,Dovish
경제/NNG;확장/NNG,7,17,24,0.2684830129891549,Dovish
경제/NNG;물가/NNG;상승/NNG,6,20,26,0.19560905232067,Dovish
전세/NNG;살/VV,8,10,18,0.5216241395217869,Dovish
좁혀/VV,58,60,118,0.6302958352554924,Dovish
주소/NNG,29,47,76,0.4023164905886122,Dovish
의존도/NNG,200,203,403,0.6423942604948113,Dovish
부쳐진/VV,13,16,29,0.5297745167018147,Dovish
세도/NNG,14,16,30,0.5705264026019543,Dovish
전망/NNG;낮/VV,14,41,55,0.2226444497958846,Dovish
분리과세/NNG,174,249,423,0.4556355435581872,Dovish
민간/NNG;소비/NNG;성장/NNG,19,23,42,0.5386336223322798,Dovish
나타났으나/VV,7,22,29,0.2074641464007106,Dovish
질권설정/NNG,7,17,24,0.2684830129891549,Dovish
소비/NNG;확대/NNG,9,12,21,0.4890226308016751,Dovish
병행/NNG,101,107,208,0.6154677347161269,Dovish
저축률/NNG;하락/NNG,2,21,23,0.0620981118478317,Dovish
경제/NNG;지표/NNG;호조/NNG,42,39,81,0.7021863416639438,Dovish
슬러/VV,17,18,35,0.6158062758243317,Dovish
전망/NNG;축소/NNG,19,54,73,0.2294180243267117,Dovish
기본법/NNG,19,26,45,0.4764835889862476,Dovish
국영기업/NNG,15,19,34,0.5147606640017633,Dovish
일차/NNG,32,34,66,0.6136754582609257,Dovish
여름철/NNG,46,44,90,0.681667909602335,Dovish
러셀/NNG,15,32,47,0.3056391442510469,Dovish
발행시장/NNG;강세/NNG,9,14,23,0.4191622549728643,Dovish
고용시장/NNG;개선/NNG,6,13,19,0.3009370035702616,Dovish
주원인/NNG,18,18,36,0.6520301744022334,Dovish
사모채/NNG,40,38,78,0.6863475520023511,Dovish
넉넉히/MAG,3,17,20,0.1150641484239235,Dovish
대립/NNG,46,53,99,0.5659129815566555,Dovish
부채/NNG;부담/NNG,23,22,45,0.681667909602335,Dovish
불확실성/NNG;완화/NNG,31,28,59,0.7218905502310442,Dovish
당좌예금/NNG,9,14,23,0.4191622549728643,Dovish
맞벌이/NNG,29,47,76,0.4023164905886122,Dovish
다각/NNG,21,50,71,0.2738526732489381,Dovish
대략/MAG,42,42,84,0.6520301744022335,Dovish
국신/NNG,1,39,40,0.01671872242057,Dovish
국제화/NNG,5,23,28,0.141745690087442,Dovish
연장선/NNG,19,21,40,0.5899320625544018,Dovish
컬처/NNG,19,17,36,0.7287396066848493,Dovish
선진/NNG,125,163,288,0.5000231398790134,Dovish
우려/NNG;금리/NNG;인하/NNG,9,9,18,0.6520301744022334,Dovish
현선물/NNG,39,59,98,0.4310029966387645,Dovish
부인/NNG,49,43,92,0.7430111289699871,Dovish
물러서/VV,9,9,18,0.6520301744022334,Dovish
폭등/NNG,17,30,47,0.3694837654945989,Dovish
전망/NNG;확대/NNG,21,23,44,0.5953318983672568,Dovish
귀여운/VA,2,18,20,0.0724477971558037,Dovish
표방/NNG,16,19,35,0.5490780416018809,Dovish
살펴본/VV,43,49,92,0.5721897448835928,Dovish
인해서/VV,30,29,59,0.6745139735195519,Dovish
무관세/NNG,9,9,18,0.6520301744022334,Dovish
이용자/NNG,60,93,153,0.4206646286466022,Dovish
도출/NNG,70,110,180,0.4149282928014213,Dovish
가계/NNG;대출/NNG;상승/NNG,8,11,19,0.4742037632016244,Dovish
금융시장/NNG;불안/NNG,23,26,49,0.5767959235096681,Dovish
기호/NNG,5,18,23,0.1811194928895093,Dovish
변환/NNG,10,22,32,0.2963773520010152,Dovish
주택/NNG;공급/NNG;활성화/NNG,16,40,56,0.2608120697608934,Dovish
상환능력/NNG;떨어/VV,12,18,30,0.4346867829348222,Dovish
연결자회사/NNG,6,24,30,0.1630075436005583,Dovish
경기/NNG;우려/NNG,12,17,29,0.4602565936956942,Dovish
소득/NNG;넘/VV,8,10,18,0.5216241395217869,Dovish
부양/NNG;확대/NNG,2,21,23,0.0620981118478317,Dovish
위시/NNG,13,15,28,0.565092817815269,Dovish
간단/NNG,41,39,80,0.6854676192433736,Dovish
간극/NNG,20,26,46,0.5015616726171027,Dovish
공사채/NNG,417,695,1112,0.3912181046413401,Dovish
대출/NNG;확대/NNG,43,39,82,0.7189050640845138,Dovish
뮤추얼펀드/NNG,13,12,25,0.7063660222690863,Dovish
모의실험/NNG,1,29,30,0.0224837991173184,Dovish
의정/NNG,8,15,23,0.3477494263478579,Dovish
생산가능인구/NNG,40,35,75,0.7451773421739812,Dovish
보우/NNG,25,48,73,0.3395990491678299,Dovish
통화/NNG;늘/VV,10,9,19,0.7244779715580372,Dovish
영업자산/NNG,22,26,48,0.551717839878813,Dovish
fed/NNG;금리/NNG;인하/NNG;기대/NNG;상승/NNG,3,18,21,0.1086716957337055,Dovish
수출/NNG;감소/NNG,29,46,75,0.411062501253582,Dovish
초년생/NNG,22,46,68,0.3118405181923725,Dovish
관대/NNG,19,33,52,0.3754113125346193,Dovish
첨예/NNG,10,17,27,0.3835471614130785,Dovish
부실채권/NNG;증가/NNG,16,20,36,0.5216241395217869,Dovish
지역리스크/NNG,9,12,21,0.4890226308016751,Dovish
색채/NNG,21,20,41,0.6846316831223452,Dovish
cr리츠/NNG,25,57,82,0.2859781466676462,Dovish
말일/NNG,9,11,20,0.5334792336018274,Dovish
중복/NNG,65,56,121,0.7568207381454496,Dovish
대출/NNG;금리/NNG;하락/NNG,21,24,45,0.5705264026019544,Dovish
연간화/NNG,7,10,17,0.4564211220815634,Dovish
우려/NNG;금리/NNG;상승/NNG,5,12,17,0.2716792393342639,Dovish
지표/NNG;금리/NNG;하락/NNG,2,29,31,0.0449675982346368,Dovish
낮/VA;하락/NNG,15,18,33,0.5433584786685278,Dovish
완화/NNG;줄/VV,6,11,17,0.3556528224012182,Dovish
기껏해야/MAG,6,23,29,0.1700948281049304,Dovish
노이즈/NNG,37,37,74,0.6520301744022335,Dovish
고정이하여신비율/NNG,123,106,229,0.7566010514290068,Dovish
금리/NNG;하방/NNG;압력/NNG,8,16,24,0.3260150872011167,Dovish
끊임없이/MAG,22,19,41,0.7549823072025862,Dovish
조달비중/NNG,8,14,22,0.3725886710869905,Dovish
신뢰/NNG,847,805,1652,0.6860491400232196,Dovish
속보치/NNG,180,168,348,0.6986037582881074,Dovish
위성/NNG,20,20,40,0.6520301744022335,Dovish
섹터별/NNG,150,203,353,0.4817956953711085,Dovish
변화/NNG,2568,2548,5116,0.6571481506534285,Dovish
개혁안/NNG,14,33,47,0.2766188618676142,Dovish
자산/NNG;줄/VV,8,10,18,0.5216241395217869,Dovish
패밀리오피스/NNG,12,22,34,0.3556528224012182,Dovish
정책/NNG;방향/NNG;성장/NNG,3,15,18,0.1304060348804467,Dovish
신용평가모델/NNG,13,64,77,0.1324436291754537,Dovish
단순/NNG,214,190,404,0.7343918806425156,Dovish
신용보증기금/NNG,61,91,152,0.4370751718520466,Dovish
가격/NNG;변동/NNG;확대/NNG,3,19,22,0.1029521328003526,Dovish
요청/NNG,292,299,591,0.6367652539312783,Dovish
바이트/NNG,7,21,28,0.2173433914674111,Dovish
베이비붐세대/NNG,6,17,23,0.2301282968478471,Dovish
오토/NNG,70,77,147,0.5927547040020305,Dovish
든다는/VV,10,9,19,0.7244779715580372,Dovish
세계/NNG;경제/NNG;회복/NNG,15,21,36,0.4657358388587382,Dovish
공개시장조작/NNG,16,31,47,0.3365317029172818,Dovish
외채/NNG,163,468,631,0.227095979546077,Dovish
합해/VV,10,11,21,0.5927547040020305,Dovish
은행/NNG;가계/NNG;대출/NNG;증가/NNG,12,16,28,0.4890226308016751,Dovish
수요/NNG;높/VA,53,48,101,0.7199499842357995,Dovish
입자/NNG,8,10,18,0.5216241395217869,Dovish
돼요/VV,22,21,43,0.6830792303261494,Dovish
하한선/NNG,13,26,39,0.3260150872011167,Dovish
이자율/NNG,309,286,595,0.7044661674485669,Dovish
그래프/NNG,46,49,95,0.6121099596429131,Dovish
발현/NNG,11,36,47,0.1992314421784602,Dovish
비관론/NNG,34,82,116,0.2703539747521455,Dovish
국채/NNG;매입/NNG;축소/NNG,15,29,44,0.3372569867597759,Dovish
무역협정/NNG,15,21,36,0.4657358388587382,Dovish
부실/NNG;확대/NNG,14,17,31,0.5369660259783099,Dovish
ebitda/NNG,125,188,313,0.4335307010653147,Dovish
공모전/NNG,12,15,27,0.5216241395217868,Dovish
리스/NNG,58,66,124,0.5729962138686294,Dovish
환승역/NNG,8,9,17,0.5795823772464298,Dovish
대유행/NNG,65,58,123,0.730723471312848,Dovish
채미/NNG,11,15,26,0.4781554612283045,Dovish
설립/NNG,364,334,698,0.7105957589293803,Dovish
직접금융/NNG,34,67,101,0.330880984025014,Dovish
빅딜/NNG,24,28,52,0.5588830066304858,Dovish
외화후순위채권/NNG,2,40,42,0.0326015087201116,Dovish
인플레이션/NNG;불안/NNG,4,17,21,0.1534188645652314,Dovish
기모/NNG,6,14,20,0.2794415033152429,Dovish
글로벌/NNG;채권/NNG;발행/NNG;성공/NNG,6,11,17,0.3556528224012182,Dovish
상호/MAG,10,9,19,0.7244779715580372,Dovish
관상/NNG,1,20,21,0.0326015087201116,Dovish
바람직/NNG,409,375,784,0.7111475768813693,Dovish
매력/NNG,904,892,1796,0.6608018807843263,Dovish
다가가/VV,9,13,22,0.4514055053553924,Dovish
소매/NNG;판매/NNG;증가/NNG,22,22,44,0.6520301744022334,Dovish
수출산업/NNG,17,23,40,0.481935346297303,Dovish
수출/NNG;걸림돌/NNG,5,14,19,0.2328679194293691,Dovish
발행시장/NNG,230,371,601,0.4042235582547539,Dovish
관리목표/NNG,10,20,30,0.3260150872011167,Dovish
통관/NNG,13,18,31,0.4709106815127242,Dovish
재점검/NNG,25,60,85,0.2716792393342639,Dovish
배정/NNG,133,178,311,0.4871910853679609,Dovish
부실/NNG;위험/NNG;크/VV,10,10,20,0.6520301744022335,Dovish
관련자/NNG,36,49,85,0.479042577111845,Dovish
자구계획/NNG,37,38,75,0.6348714856021748,Dovish
기업개선작업/NNG,12,12,24,0.6520301744022334,Dovish
설상가상/NNG,18,17,35,0.6903848905435414,Dovish
교육비/NNG,16,19,35,0.5490780416018809,Dovish
획일/NNG,7,10,17,0.4564211220815634,Dovish
계란/NNG,8,10,18,0.5216241395217869,Dovish
편중/NNG,50,59,109,0.5525679444086725,Dovish
누적/NNG,1188,1120,2308,0.6916177207052263,Dovish
부양/NNG;효과/NNG,28,28,56,0.6520301744022334,Dovish
무위험/NNG,91,80,171,0.7416843233825406,Dovish
당첨자/NNG,78,97,175,0.5243129237461259,Dovish
물음/NNG,9,9,18,0.6520301744022334,Dovish
유관/NNG,55,99,154,0.3622389857790186,Dovish
실효환율/NNG,26,55,81,0.3082324460810558,Dovish
백서/NNG,7,28,35,0.1630075436005583,Dovish
단기/NNG;금리/NNG;하락/NNG,5,17,22,0.1917735807065392,Dovish
중소형주/NNG,60,57,117,0.686347552002351,Dovish
요약/NNG,215,214,429,0.6550770443760757,Dovish
냉동/NNG,24,28,52,0.5588830066304858,Dovish
총액/NNG,356,384,740,0.6044863075187372,Dovish
펀더멘털/NNG,597,686,1283,0.5674373383646261,Dovish
유럽연합/NNG,77,88,165,0.5705264026019543,Dovish
주어진다/VV,19,38,57,0.3260150872011167,Dovish
스쿠프/NNG,9,12,21,0.4890226308016751,Dovish
전병/NNG,48,117,165,0.2674995587291214,Dovish
금융위기/NNG,584,704,1288,0.5408886674018528,Dovish
부채/NNG;축소/NNG,8,10,18,0.5216241395217869,Dovish
실증분석/NNG,10,20,30,0.3260150872011167,Dovish
완만/NNG,736,808,1544,0.5939284756931236,Dovish
채권시장/NNG,2111,2298,4409,0.5989711480257245,Dovish
굳어지/VV,10,12,22,0.5433584786685279,Dovish
자절/NNG,1,17,18,0.0383547161413078,Dovish
차트/NNG,234,285,519,0.5353510905618338,Dovish
경상/NNG;수지/NNG;상품/NNG;수지/NNG;흑자/NNG,6,13,19,0.3009370035702616,Dovish
고정/NNG,863,864,1727,0.6512755098485271,Dovish
엄중/NNG,17,23,40,0.481935346297303,Dovish
상하수도/NNG,4,15,19,0.1738747131739289,Dovish
상환/NNG;부담/NNG;완화/NNG,5,31,36,0.1051661571616505,Dovish
단기물/NNG;약세/NNG,8,15,23,0.3477494263478579,Dovish
다방면/NNG,21,29,50,0.4721597814636864,Dovish
등급/NNG,1600,1799,3399,0.5799045464388959,Dovish
자영업자/NNG,836,780,1616,0.6988425971798298,Dovish
군산/NNG,13,14,27,0.6054565905163597,Dovish
월보/NNG,28,32,60,0.5705264026019543,Dovish
전고점/NNG;회복/NNG,9,9,18,0.6520301744022334,Dovish
테너/NNG,4,19,23,0.1372695104004702,Dovish
상수/NNG,10,10,20,0.6520301744022335,Dovish
금융시장/NNG,2095,2123,4218,0.6434306242923595,Dovish
상당기간/NNG,184,212,396,0.5659129815566555,Dovish
위험가중치/NNG,16,27,43,0.3863882514976198,Dovish
대림/NNG,16,19,35,0.5490780416018809,Dovish
신뢰지수/NNG,114,166,280,0.4477797583244253,Dovish
역차별/NNG,11,11,22,0.6520301744022334,Dovish
불입/NNG,7,12,19,0.3803509350679695,Dovish
턱밑/NNG,8,10,18,0.5216241395217869,Dovish
법원경매/NNG,40,41,81,0.6361269994168132,Dovish
oecd/NNG,387,352,739,0.7168627201524556,Dovish
그림자금융/NNG,29,31,60,0.6099637115375733,Dovish
던진/VV,15,17,32,0.5753207421196178,Dovish
부채한도/NNG,15,26,41,0.376171254462827,Dovish
대출심사/NNG;강화/NNG,7,24,31,0.1901754675339847,Dovish
유류/NNG,13,20,33,0.4238196133614518,Dovish
산금/NNG,27,39,66,0.4514055053553923,Dovish
공식입장/NNG,10,10,20,0.6520301744022335,Dovish
금리/NNG;불안/NNG,16,17,33,0.6136754582609257,Dovish
양방향/NNG,24,33,57,0.4742037632016243,Dovish
직매입/NNG,14,93,107,0.0981550800175405,Dovish
대출/NNG;한도/NNG;축소/NNG,2,18,20,0.0724477971558037,Dovish
국고채/NNG;금리/NNG;급등/NNG,8,13,21,0.4012493380936822,Dovish
위험요인/NNG,207,207,414,0.6520301744022335,Dovish
부양비/NNG,1,22,23,0.0296377352001015,Dovish
투영/NNG,9,11,20,0.5334792336018274,Dovish
고쳐야/VV,12,11,23,0.7113056448024364,Dovish
순수익/NNG,6,18,24,0.2173433914674111,Dovish
향한/VV,90,99,189,0.5927547040020305,Dovish
배당투자/NNG,14,18,32,0.5071345800906261,Dovish
어떠/NNG,731,776,1507,0.6142191462474648,Dovish
비경제활동인구/NNG;증가/NNG,1,16,17,0.0407518859001395,Dovish
對中/NNG,12,14,26,0.5588830066304858,Dovish
성실/NNG,41,53,94,0.5044007009526712,Dovish
우위/NNG,176,153,329,0.7500477823189091,Dovish
개발공사/NNG,41,65,106,0.4112805715460241,Dovish
하락/NNG;우위/NNG,8,10,18,0.5216241395217869,Dovish
무가/NNG,8,13,21,0.4012493380936822,Dovish
수출금융/NNG,30,66,96,0.2963773520010151,Dovish
회색코뿔소/NNG,1,33,34,0.019758490133401,Dovish
소매/NNG,1008,947,1955,0.6940300061219127,Dovish
살짝/MAG,48,44,92,0.7113056448024364,Dovish
단기물/NNG;강세/NNG,9,16,25,0.3667669731012563,Dovish
재정정책/NNG,356,382,738,0.6076511572963224,Dovish
철폐/NNG,23,20,43,0.7498347005625685,Dovish
드러난다/VV,10,10,20,0.6520301744022335,Dovish
유인책/NNG,13,22,35,0.3852905576013198,Dovish
네옴/NNG,10,20,30,0.3260150872011167,Dovish
대명/NNG,11,17,28,0.4219018775543863,Dovish
등락/NNG,587,576,1163,0.6644821395383872,Dovish
코트/NNG,15,27,42,0.3622389857790185,Dovish
구원/NNG,28,30,58,0.6085614961087512,Dovish
공모채/NNG,114,108,222,0.6882540729801353,Dovish
보완책/NNG,16,23,39,0.4535862082798146,Dovish
애매/NNG,35,31,66,0.736163100131554,Dovish
감속/NNG,16,92,108,0.1133965520699536,Dovish
경제/NNG;연착륙/NNG,20,23,43,0.5669827603497682,Dovish
대환/NNG,141,157,298,0.5855812394313052,Dovish
개선/NNG;내수/NNG;회복/NNG,8,19,27,0.2745390208009404,Dovish
금리/NNG;강세/NNG,16,15,31,0.6954988526957158,Dovish
개발이익/NNG,7,14,21,0.3260150872011167,Dovish
놓인/VV,30,31,61,0.6309969429699034,Dovish
적당/NNG,37,32,69,0.7539098891525825,Dovish
우대/NNG,419,402,821,0.6796035897376513,Dovish
국경/NNG,53,54,107,0.6399555415429328,Dovish
곤란/NNG,43,62,105,0.4522144757950974,Dovish
로이터상품가격지수/NNG,15,13,28,0.752342508925654,Dovish
덕택/NNG,20,18,38,0.7244779715580372,Dovish
운송장/NNG,14,19,33,0.4804432864016457,Dovish
통업/NNG,9,15,24,0.39121810464134,Dovish
전송/NNG,88,111,199,0.5169248229495185,Dovish
비은행/NNG,258,241,499,0.6980240041318517,Dovish
bbb-등급/NNG,13,28,41,0.3027282952581798,Dovish
감정평가/NNG,13,20,33,0.4238196133614518,Dovish
업황/NNG;좋/VA,11,12,23,0.5976943265353807,Dovish
경제/NNG;위험/NNG,9,12,21,0.4890226308016751,Dovish
구름/NNG,9,8,17,0.7335339462025127,Dovish
내리막길/NNG,20,19,39,0.6863475520023511,Dovish
위험/NNG;확산/NNG,12,12,24,0.6520301744022334,Dovish
환경/NNG;부정적/VAX,4,13,17,0.2006246690468411,Dovish
멸실/NNG,6,12,18,0.3260150872011167,Dovish
사로잡/VV,19,19,38,0.6520301744022335,Dovish
튼튼/NNG,20,26,46,0.5015616726171027,Dovish
퇴출/NNG,38,42,80,0.5899320625544018,Dovish
후행/NNG,44,55,99,0.5216241395217868,Dovish
지원기업/NNG,16,15,31,0.6954988526957158,Dovish
건당/NNG,19,25,44,0.4955429325456975,Dovish
대공황/NNG,17,18,35,0.6158062758243317,Dovish
차입/NNG,775,774,1549,0.6528725906482312,Dovish
서서히/MAG,390,346,736,0.7349473064071418,Dovish
외환시장/NNG;원달러/NNG;오르/VV,20,18,38,0.7244779715580372,Dovish
후유증/NNG,16,24,40,0.4346867829348224,Dovish
기술금융/NNG,17,23,40,0.481935346297303,Dovish
실망매물/NNG,10,20,30,0.3260150872011167,Dovish
레벨/NNG,434,443,877,0.6387835117168608,Dovish
통안계정/NNG,11,23,34,0.3118405181923725,Dovish
동계/NNG,5,16,21,0.2037594295006979,Dovish
신이/NNG,5,13,18,0.2507808363085513,Dovish
차액/NNG,21,42,63,0.3260150872011167,Dovish
계기/NNG,300,274,574,0.713901650805365,Dovish
경제주체/NNG,196,387,583,0.3302271684311054,Dovish
시뮬레이션/NNG,26,35,61,0.4843652724130878,Dovish
後者/NNG,8,10,18,0.5216241395217869,Dovish
건전성/NNG;악화/NNG,34,35,69,0.633400740847884,Dovish
산금채/NNG,79,127,206,0.4055935730533578,Dovish
적이/VV,4,32,36,0.0815037718002791,Dovish
순방/NNG,17,19,36,0.5833954192019984,Dovish
상공인/NNG,7,18,25,0.253567290045313,Dovish
아동/NNG,50,57,107,0.5719562933352925,Dovish
나선다는/VV,25,29,54,0.5620949779329599,Dovish
여력/NNG;확충/NNG,2,22,24,0.059275470400203,Dovish
재평가/NNG,83,94,177,0.575728771014738,Dovish
평가금액/NNG,11,15,26,0.4781554612283045,Dovish
국제에너지기구/NNG,9,8,17,0.7335339462025127,Dovish
성장/NNG;경로/NNG;불확실성/NNG,8,10,18,0.5216241395217869,Dovish
이북/NNG,3,33,36,0.059275470400203,Dovish
예대율/NNG,91,107,198,0.5545303352392827,Dovish
성서/NNG,6,14,20,0.2794415033152429,Dovish
크레딧/NNG,1675,2441,4116,0.4474193126275055,Dovish
하만/NNG,4,14,18,0.1862943355434952,Dovish
지점/NNG,349,399,748,0.5703221324971918,Dovish
소중/NNG,25,28,53,0.5821697985734228,Dovish
시계열/NNG,24,58,82,0.2698055894078207,Dovish
장인/NNG,11,10,21,0.7172331918424568,Dovish
순수/NNG,73,76,149,0.6262921412021454,Dovish
배고프/VV,1,23,24,0.0283491380174884,Dovish
당면/NNG,28,42,70,0.4346867829348223,Dovish
공존/NNG,40,45,85,0.5795823772464298,Dovish
건설/NNG;경기/NNG;악화/NNG,14,14,28,0.6520301744022334,Dovish
첫날/NNG,90,89,179,0.6593563561370901,Dovish
상향/NNG;전망/NNG;상향/NNG,13,12,25,0.7063660222690863,Dovish
마군/NNG,15,25,40,0.39121810464134,Dovish
우축/NNG,34,35,69,0.633400740847884,Dovish
엑소더스/NNG,7,13,20,0.3510931708319719,Dovish
뾰족/MAG,9,8,17,0.7335339462025127,Dovish
자유무역협정/NNG,10,16,26,0.4075188590013959,Dovish
원리금/NNG,442,642,1084,0.4489055094794193,Dovish
완성도/NNG,11,10,21,0.7172331918424568,Dovish
완화/NNG;효과/NNG,12,11,23,0.7113056448024364,Dovish
cd/NNG,1275,1385,2660,0.6002443843775074,Dovish
미매각/NNG,175,264,439,0.4322169716681471,Dovish
유동성/NNG;공급/NNG;확대/NNG,10,10,20,0.6520301744022335,Dovish
특별히/MAG,25,46,71,0.3543642252186051,Dovish
발동/NNG,24,21,45,0.745177342173981,Dovish
바이아웃/NNG,10,21,31,0.3104905592391588,Dovish
경제활동참가율/NNG,18,37,55,0.3172038686281136,Dovish
스트레스/NNG,138,544,682,0.1654047133593901,Dovish
자금운용계획/NNG,9,8,17,0.7335339462025127,Dovish
연체금액/NNG,36,63,99,0.3725886710869905,Dovish
어느덧/MAG,8,10,18,0.5216241395217869,Dovish
순상/NNG,44,79,123,0.3631560465025097,Dovish
부족량/NNG,1,17,18,0.0383547161413078,Dovish
일용직/NNG,12,14,26,0.5588830066304858,Dovish
채무자/NNG,83,110,193,0.4919864043216852,Dovish
회복/NNG;지연/NNG,34,31,65,0.7151298686992238,Dovish
톤틴연금/NNG,2,15,17,0.0869373565869644,Dovish
평점/NNG,84,131,215,0.4180956843495238,Dovish
소프트패치/NNG,17,17,34,0.6520301744022335,Dovish
지급보증/NNG,37,71,108,0.3397903725758118,Dovish
가세/NNG,104,110,214,0.6164648921621116,Dovish
은행/NNG;자본/NNG;확충/NNG,8,10,18,0.5216241395217869,Dovish
이젠/MAG,11,16,27,0.4482707449015355,Dovish
공개시장/NNG,18,24,42,0.4890226308016751,Dovish
위험/NNG;낮/VA,27,37,64,0.4758058029421703,Dovish
최대/NNG;적자/NNG,5,14,19,0.2328679194293691,Dovish
수출/NNG;부진/NNG,17,25,42,0.4433805185935188,Dovish
부채/NNG;감소/NNG,9,8,17,0.7335339462025127,Dovish
도내/NNG,15,15,30,0.6520301744022334,Dovish
경제/NNG;지표/NNG;부진/NNG,25,23,48,0.7087284504372103,Dovish
원단위/NNG,20,61,81,0.2137803850499126,Dovish
손상/NNG,37,32,69,0.7539098891525825,Dovish
지수/NNG;하락/NNG;막/VV,7,10,17,0.4564211220815634,Dovish
재정보강/NNG,5,15,20,0.2173433914674111,Dovish
대차대조표/NNG,82,104,186,0.5141007144325302,Dovish
최대/NNG;넘/VV,11,11,22,0.6520301744022334,Dovish
산품/NNG,8,12,20,0.4346867829348224,Dovish
완만/NNG;성장/NNG,27,25,52,0.7041925883544121,Dovish
비금융공기업/NNG,4,45,49,0.0579582377246429,Dovish
딜레마/NNG,24,24,48,0.6520301744022334,Dovish
회복/NNG;견인/NNG,9,8,17,0.7335339462025127,Dovish
금융상황/NNG,60,93,153,0.4206646286466022,Dovish
투기과열지구/NNG,9,14,23,0.4191622549728643,Dovish
그래요/VV,7,24,31,0.1901754675339847,Dovish
굴곡진/VA,12,12,24,0.6520301744022334,Dovish
가운/NNG,13,19,32,0.4461259088015282,Dovish
파트너/NNG,147,130,277,0.7372956587471409,Dovish
철학/NNG,27,29,56,0.6070625761675967,Dovish
백만장자/NNG,7,14,21,0.3260150872011167,Dovish
고유동성/NNG,38,36,74,0.6882540729801354,Dovish
금리/NNG;높/VV,34,59,93,0.3757462021978973,Dovish
이자비용/NNG;늘/VV,10,16,26,0.4075188590013959,Dovish
차익거래/NNG,47,46,93,0.6662047434109777,Dovish
도유/NNG,1,22,23,0.0296377352001015,Dovish
민심/NNG,16,18,34,0.5795823772464298,Dovish
gdp/NNG;갭/NNG;마이너스/NNG,2,17,19,0.0767094322826157,Dovish
강서/NNG,19,20,39,0.6194286656821218,Dovish
재협상/NNG,15,27,42,0.3622389857790185,Dovish
부채/NNG,3445,3182,6627,0.7059220461394389,Dovish
금리/NNG;소폭/MAG;하락/NNG,23,29,52,0.5171273796983231,Dovish
성장성/NNG;높/VA,19,40,59,0.3097143328410609,Dovish
코너/NNG,30,28,58,0.6986037582881073,Dovish
여전채/NNG,1062,1401,2463,0.4942584191400228,Dovish
국영/NNG,22,31,53,0.4627310915112624,Dovish
이해도/NNG,15,14,29,0.6986037582881073,Dovish
만기/NNG,3796,3524,7320,0.7023571345150051,Dovish
cds/NNG;상승/NNG,8,9,17,0.5795823772464298,Dovish
한발/MAG,34,37,71,0.5991628629642146,Dovish
자정/NNG,13,22,35,0.3852905576013198,Dovish
상위등급/NNG,47,189,236,0.162145069824894,Dovish
클수록/VV,25,22,47,0.740943380002538,Dovish
난해/NNG,7,10,17,0.4564211220815634,Dovish
예금은행/NNG,86,109,195,0.5144458256751567,Dovish
연소득/NNG,91,90,181,0.6592749541178139,Dovish
엿보이/VV,7,14,21,0.3260150872011167,Dovish
스모/NNG,1,25,26,0.0260812069760893,Dovish
갖출/VV,35,31,66,0.736163100131554,Dovish
봉천/NNG,6,11,17,0.3556528224012182,Dovish
금리/NNG;충격/NNG,20,23,43,0.5669827603497682,Dovish
금융투자회사/NNG,13,13,26,0.6520301744022335,Dovish
수익/NNG;감소/NNG,24,21,45,0.745177342173981,Dovish
세후수익률/NNG,9,24,33,0.2445113154008375,Dovish
승인액/NNG,9,19,28,0.308856398401058,Dovish
평판/NNG,16,15,31,0.6954988526957158,Dovish
위험/NNG;피하/VV,11,21,32,0.3415396151630747,Dovish
냉정/NNG,16,15,31,0.6954988526957158,Dovish
방금/MAG,11,14,25,0.512309422744612,Dovish
금리/NNG;반대/NNG,11,19,30,0.3774911536012931,Dovish
강연/NNG,89,81,170,0.7164282163185035,Dovish
청역/NNG,6,11,17,0.3556528224012182,Dovish
지표물/NNG,61,61,122,0.6520301744022335,Dovish
비경제활동인구/NNG,4,24,28,0.1086716957337056,Dovish
거래자/NNG,15,23,38,0.4252370702623262,Dovish
운전자금/NNG,40,41,81,0.6361269994168132,Dovish
하락/NNG;금리/NNG;인하/NNG,11,16,27,0.4482707449015355,Dovish
인하/NNG;가능성/NNG;높/VA,4,17,21,0.1534188645652314,Dovish
소비/NNG;모멘텀/NNG,3,17,20,0.1150641484239235,Dovish
온실가스배출량/NNG,8,15,23,0.3477494263478579,Dovish
그라운드/NNG,15,13,28,0.752342508925654,Dovish
아마도/MAG,47,55,102,0.5571894217619086,Dovish
스왑베이시스/NNG,75,86,161,0.5686309660484594,Dovish
국무/NNG,11,18,29,0.3984628843569204,Dovish
발행일/NNG,58,85,143,0.4449147072391711,Dovish
이자율/NNG;높/VA,14,28,42,0.3260150872011167,Dovish
투표/NNG,150,180,330,0.5433584786685279,Dovish
임차/NNG,134,148,282,0.5903516443912115,Dovish
통합계좌/NNG,6,18,24,0.2173433914674111,Dovish
상일/NNG,5,16,21,0.2037594295006979,Dovish
성장/NNG;하방/NNG;위험/NNG,6,15,21,0.2608120697608934,Dovish
순환변동치/NNG,80,82,162,0.6361269994168132,Dovish
주택/NNG;거래/NNG;늘/VV,11,13,24,0.551717839878813,Dovish
건국/NNG,11,14,25,0.512309422744612,Dovish
자신/NNG,879,806,1685,0.7110850165006988,Dovish
무역보험공사/NNG,20,33,53,0.3951698026680202,Dovish
경기/NNG;회복/NNG;둔화/NNG,9,30,39,0.19560905232067,Dovish
부리/VV,12,11,23,0.7113056448024364,Dovish
나눔/VV,54,54,108,0.6520301744022334,Dovish
아꼈/VV,9,26,35,0.2257027526776962,Dovish
성장/NNG;정체/NNG,10,10,20,0.6520301744022335,Dovish
상향/NNG;등급/NNG;상향/NNG,9,11,20,0.5334792336018274,Dovish
모아야/VV,11,28,39,0.256154711372306,Dovish
술위/NNG,2,18,20,0.0724477971558037,Dovish
각별히/MAG,17,20,37,0.5542256482418985,Dovish
금리/NNG;오르/VV;안정/NNG,1,18,19,0.0362238985779018,Dovish
균등/NNG,87,82,169,0.6917881118657843,Dovish
클릭/NNG,10,21,31,0.3104905592391588,Dovish
고가주택/NNG,13,32,45,0.2648872583509074,Dovish
수요/NNG;증대/NNG,11,12,23,0.5976943265353807,Dovish
본다면/VV,28,40,68,0.4564211220815634,Dovish
브렉시트/NNG,80,467,547,0.1116968178847509,Dovish
이표채/NNG,46,98,144,0.3060549798214566,Dovish
불안정성/NNG,52,66,118,0.5137207434684263,Dovish
미선/NNG,374,542,916,0.4499248804915781,Dovish
장기화/NNG,23,22,45,0.681667909602335,Dovish
위험/NNG;낮/VV,9,19,28,0.308856398401058,Dovish
하역/NNG,10,9,19,0.7244779715580372,Dovish
덕우/NNG,6,11,17,0.3556528224012182,Dovish
상해/VV,107,157,264,0.4443772526180827,Dovish
지지율/NNG,24,62,86,0.2523987771879613,Dovish
투자/NNG;재원/NNG;확보/NNG,4,15,19,0.1738747131739289,Dovish
하향/NNG,1486,1820,3306,0.5323718896492962,Dovish
과세표준/NNG,9,9,18,0.6520301744022334,Dovish
당연/NNG,74,83,157,0.5813281072983768,Dovish
최종/NNG,1025,909,1934,0.7352375453930576,Dovish
마이너스수익률/NNG,22,21,43,0.6830792303261494,Dovish
명종/NNG,10,49,59,0.133067382531068,Dovish
이럴/VV,9,8,17,0.7335339462025127,Dovish
마이너스gdp/NNG,19,55,74,0.2252467875207715,Dovish
전광판/NNG,21,22,43,0.622392439202132,Dovish
가미/NNG,14,21,35,0.4346867829348223,Dovish
턱걸이/NNG,10,9,19,0.7244779715580372,Dovish
대의/NNG,18,23,41,0.5102844843147915,Dovish
교부금/NNG,10,16,26,0.4075188590013959,Dovish
고정금리부/NNG,8,10,18,0.5216241395217869,Dovish
경기/NNG;회복/NNG;지연/NNG,28,27,55,0.6761794401208346,Dovish
번거/NNG,10,20,30,0.3260150872011167,Dovish
차주/NNG;상환/NNG;부담/NNG,9,27,36,0.2173433914674111,Dovish
특별참가자/NNG,1,17,18,0.0383547161413078,Dovish
모티브/NNG,11,15,26,0.4781554612283045,Dovish
누르/VV,20,26,46,0.5015616726171027,Dovish
흔적/NNG,11,10,21,0.7172331918424568,Dovish
경제/NNG;전망/NNG;하향/NNG,7,19,26,0.2402216432008228,Dovish
타결/NNG,39,48,87,0.5297745167018147,Dovish
관리지역/NNG,20,18,38,0.7244779715580372,Dovish
에너지저장장치/NNG,11,11,22,0.6520301744022334,Dovish
크레딧/NNG;약세/NNG,11,11,22,0.6520301744022334,Dovish
대손충당금/NNG,240,242,482,0.6466414952749423,Dovish
