pos_dic,Up,Down,total,Polarity Score,Polarity
보충/NNG,50,25,75,1.3040603488044669,Hawkish
성급/NNG,53,24,77,1.439899968471599,Hawkish
반값/NNG,32,9,41,2.318329508985719,Hawkish
밝힐/VV,15,7,22,1.3972075165762146,Hawkish
전세가격/NNG;하락/NNG,16,4,20,2.608120697608934,Hawkish
저리/NNG,160,58,218,1.798703929385472,Hawkish
이루어져/VV,19,7,26,1.7697961876632051,Hawkish
내수/NNG;진작/NNG,26,13,39,1.304060348804467,Hawkish
식품기업/NNG,26,12,38,1.4127320445381726,Hawkish
구하/VV,134,41,175,2.131025448046324,Hawkish
순이익/NNG;늘/VV,55,16,71,2.241353724507678,Hawkish
공급/NNG;과잉/NNG;우려/NNG,26,1,27,16.952784534458072,Hawkish
원수/NNG,31,14,45,1.4437811004620884,Hawkish
대손비용/NNG;증가/NNG,32,13,45,1.6049973523747287,Hawkish
상고하저/NNG,33,15,48,1.4344663836849136,Hawkish
종합과세/NNG,25,11,36,1.481886760005076,Hawkish
국무원/NNG,28,14,42,1.3040603488044669,Hawkish
집합건물/NNG,31,11,42,1.8375395824062943,Hawkish
적자/NNG;줄/VV,29,7,36,2.701267865380682,Hawkish
미성년/NNG,18,3,21,3.912181046413401,Hawkish
수탁은행/NNG,23,1,24,14.996694011251371,Hawkish
침체/NNG;빠지/VV,24,10,34,1.5648724185653602,Hawkish
선과/NNG,16,4,20,2.608120697608934,Hawkish
상방/NNG,312,144,456,1.4127320445381726,Hawkish
도급계약/NNG,30,4,34,4.890226308016751,Hawkish
산다/VV,15,7,22,1.3972075165762146,Hawkish
어둡/VA,70,30,100,1.521403740271878,Hawkish
사생활/NNG,18,6,24,1.9560905232067003,Hawkish
고객비중/NNG,23,6,29,2.4994490018752287,Hawkish
포기/NNG,181,88,269,1.341107517804594,Hawkish
엄정히/MAG,17,6,23,1.847418827472995,Hawkish
반경/NNG,21,7,28,1.9560905232067007,Hawkish
겸임/NNG,50,11,61,2.963773520010152,Hawkish
품종/NNG,21,1,22,13.692633662446903,Hawkish
반군/NNG,14,5,19,1.8256844883262535,Hawkish
지수/NNG;높/VA,27,9,36,1.9560905232067003,Hawkish
농촌/NNG,65,24,89,1.7659150556727157,Hawkish
탈취/NNG,14,5,19,1.8256844883262535,Hawkish
쏠린다/VV,124,41,165,1.971993698192121,Hawkish
의향/NNG,59,4,63,9.617445072432943,Hawkish
발걸음/NNG,24,10,34,1.5648724185653602,Hawkish
일어나/VV,281,137,418,1.337375759175384,Hawkish
가격/NNG;상승/NNG;둔화/NNG,12,6,18,1.3040603488044669,Hawkish
준가/NNG,43,1,44,28.03729749929604,Hawkish
공급계획/NNG,121,19,140,4.152402689614225,Hawkish
접대비/NNG,16,1,17,10.432482790435737,Hawkish
기업집단/NNG,15,3,18,3.260150872011167,Hawkish
이익/NNG,1759,807,2566,1.421215708517384,Hawkish
외국은행/NNG,31,3,34,6.737645135489746,Hawkish
원자로/NNG,13,6,19,1.4127320445381726,Hawkish
사용액/NNG,22,4,26,3.5861659592122845,Hawkish
안정/NNG;성장/NNG,63,27,90,1.521403740271878,Hawkish
취득세/NNG,140,59,199,1.547190244344283,Hawkish
개선/NNG;긍정적/VAX,16,5,21,2.0864965580871475,Hawkish
소비자/NNG;물가/NNG;예상/NNG;높/VA,16,4,20,2.608120697608934,Hawkish
패스/NNG,30,2,32,9.780452616033502,Hawkish
과도/NNG;불안/NNG,21,2,23,6.846316831223453,Hawkish
궁금증/NNG,27,12,39,1.467067892405025,Hawkish
기대/NNG;밑돌/VV,19,6,25,2.0647622189404062,Hawkish
특별대출/NNG,26,6,32,2.825464089076345,Hawkish
주거용건물/NNG,18,7,25,1.6766490198914574,Hawkish
리서치팀/NNG,23,6,29,2.4994490018752287,Hawkish
자칫/MAG,118,51,169,1.5086188348914422,Hawkish
투자/NNG;촉진/NNG,25,9,34,1.811194928895093,Hawkish
허리띠/NNG,28,5,33,3.651368976652508,Hawkish
여실히/MAG,21,5,26,2.738526732489381,Hawkish
쓰인다/VV,32,11,43,1.896815052806497,Hawkish
고시/NNG,74,33,107,1.462128269871675,Hawkish
희소식/NNG,18,2,20,5.868271569620101,Hawkish
포장/NNG,24,6,30,2.6081206976089337,Hawkish
격언/NNG,30,11,41,1.7782641120060911,Hawkish
마쳤으며/VV,13,5,18,1.6952784534458072,Hawkish
호실적/NNG,382,134,516,1.858772586728755,Hawkish
건설/NNG;투자/NNG;부진/NNG,26,5,31,3.3905569068916144,Hawkish
공급/NNG;줄/VV,54,25,79,1.4083851767088242,Hawkish
학부/NNG,120,58,178,1.3490279470391038,Hawkish
재조명/NNG,16,2,18,5.216241395217868,Hawkish
원내대표/NNG,39,10,49,2.542917680168711,Hawkish
덩달/VV,107,50,157,1.3953445732207796,Hawkish
수익구조/NNG,104,33,137,2.0548829738737053,Hawkish
인플레이션/NNG;부담/NNG,22,5,27,2.8689327673698277,Hawkish
응답/NNG,500,185,685,1.7622437146006311,Hawkish
가로/NNG,63,15,78,2.7385267324893805,Hawkish
교환사채/NNG,16,8,24,1.304060348804467,Hawkish
미아/NNG,21,4,25,3.4231584156117263,Hawkish
fed/NNG;통화정책/NNG;불확실성/NNG,33,14,47,1.536928268233836,Hawkish
리얼티/NNG,30,11,41,1.7782641120060911,Hawkish
일으켰/VV,27,9,36,1.9560905232067003,Hawkish
기은/NNG,29,4,33,4.727218764416193,Hawkish
도봉/NNG,30,11,41,1.7782641120060911,Hawkish
블록체인/NNG,86,37,123,1.5155295945565428,Hawkish
실행계획/NNG,13,4,17,2.119098066807259,Hawkish
활주로/NNG,25,1,26,16.300754360055837,Hawkish
메뉴/NNG,111,52,163,1.39183364151246,Hawkish
보증채무/NNG,28,2,30,9.128422441631267,Hawkish
경제/NNG;성장률/NNG;상향/NNG,28,8,36,2.282105610407817,Hawkish
르네상스/NNG,22,7,29,2.049237690978448,Hawkish
성황리/NNG,25,7,32,2.328679194293691,Hawkish
돌아/VV,1128,491,1619,1.4979430483212208,Hawkish
사무소/NNG,161,62,223,1.6931751303025742,Hawkish
무담보채/NNG,60,11,71,3.5565282240121823,Hawkish
특권/NNG,22,3,25,4.7815546122830455,Hawkish
기반시설/NNG,35,12,47,1.901754675339848,Hawkish
내밀/VV,19,8,27,1.548571664205305,Hawkish
대출/NNG;최저/NNG,18,4,22,2.9341357848100507,Hawkish
실물/NNG;경제/NNG;우려/NNG,16,3,19,3.477494263478579,Hawkish
트로이온스/NNG,47,21,68,1.4593056284240464,Hawkish
사별/NNG,37,17,54,1.4191244972283903,Hawkish
서학/NNG,169,77,246,1.4310792139477593,Hawkish
고급화/NNG,30,12,42,1.6300754360055836,Hawkish
판매/NNG;확대/NNG,73,11,84,4.327109339214823,Hawkish
글로벌경영/NNG,30,5,35,3.912181046413401,Hawkish
일감/NNG,79,12,91,4.29253198148137,Hawkish
엠파이어/NNG,21,7,28,1.9560905232067007,Hawkish
한국물/NNG,21,6,27,2.2821056104078177,Hawkish
수위/NNG,98,35,133,1.825684488326254,Hawkish
가까이/MAG,952,476,1428,1.3040603488044669,Hawkish
독특/NNG,22,8,30,1.7930829796061425,Hawkish
회국/NNG,17,1,18,11.08451296483797,Hawkish
경강선/NNG,20,2,22,6.520301744022335,Hawkish
와우/NNG,17,5,22,2.216902592967594,Hawkish
사각지대/NNG,67,13,80,3.3604632065345883,Hawkish
자율주행/NNG,115,45,160,1.6662993345834858,Hawkish
소모/NNG,21,8,29,1.7115792078058631,Hawkish
대출/NNG;증가/NNG;둔화/NNG,15,5,20,1.9560905232067003,Hawkish
이용료/NNG,134,66,200,1.323818838937868,Hawkish
추진계획/NNG,24,7,31,2.2355320265219434,Hawkish
기대/NNG;상승/NNG,38,13,51,1.9059343559449904,Hawkish
특근/NNG,22,3,25,4.7815546122830455,Hawkish
정류장/NNG,14,4,18,2.282105610407817,Hawkish
전부/NNG,75,20,95,2.4451131540083755,Hawkish
경영진단/NNG,14,3,17,3.042807480543756,Hawkish
상판/NNG,17,3,20,3.69483765494599,Hawkish
향했/VV,12,6,18,1.3040603488044669,Hawkish
발코니/NNG,24,11,35,1.4226112896048728,Hawkish
공동선언문/NNG,93,1,94,60.63880621940772,Hawkish
폭염/NNG,50,11,61,2.963773520010152,Hawkish
점차/MAG;완화/NNG,37,9,46,2.6805684947647377,Hawkish
치우/VV,13,6,19,1.4127320445381726,Hawkish
대답/NNG,24,7,31,2.2355320265219434,Hawkish
재무장관회의/NNG,128,55,183,1.517452042245198,Hawkish
총영사관/NNG,24,6,30,2.6081206976089337,Hawkish
신용/NNG;부실/NNG,22,1,23,14.344663836849138,Hawkish
금리/NNG;인하/NNG;가능성/NNG;배제/NNG,65,20,85,2.119098066807259,Hawkish
자생적/VAX,30,13,43,1.504685017851308,Hawkish
장도/NNG,17,6,23,1.847418827472995,Hawkish
시달렸/VV,15,3,18,3.260150872011167,Hawkish
특별시/NNG,22,6,28,2.3907773061415227,Hawkish
초보/NNG,22,8,30,1.7930829796061425,Hawkish
따라갈/VV,26,11,37,1.5411622304052792,Hawkish
외식업/NNG,107,17,124,4.10395462711994,Hawkish
상장종목/NNG,31,6,37,3.368822567744873,Hawkish
달리/MAG;금리/NNG;인하/NNG,12,6,18,1.3040603488044669,Hawkish
대출포트폴리오/NNG,17,5,22,2.216902592967594,Hawkish
pf/NNG,5569,2373,7942,1.530196393276881,Hawkish
끈적/NNG,58,27,85,1.400657411678872,Hawkish
지연/NNG,1944,944,2888,1.3427401049130745,Hawkish
긴축/NNG;선호/NNG,24,9,33,1.738747131739289,Hawkish
안주/NNG,28,10,38,1.8256844883262535,Hawkish
외무/NNG,26,6,32,2.825464089076345,Hawkish
투쟁/NNG,19,6,25,2.0647622189404062,Hawkish
패배/NNG,43,6,49,4.67288291654934,Hawkish
악영향/NNG;줄/VV,15,4,19,2.4451131540083755,Hawkish
안갯속/NNG,47,11,58,2.785947108809543,Hawkish
싸늘/NNG,17,1,18,11.08451296483797,Hawkish
최상/NNG,22,3,25,4.7815546122830455,Hawkish
외부자금/NNG,62,8,70,5.05323385161731,Hawkish
섹터etf/NNG,55,1,56,35.86165959212285,Hawkish
굴착기/NNG,16,5,21,2.0864965580871475,Hawkish
묶였/VV,16,6,22,1.7387471317392895,Hawkish
꿈꾸/VV,36,18,54,1.3040603488044669,Hawkish
실손/NNG,111,9,120,8.041705484294212,Hawkish
전문업체/NNG,36,8,44,2.9341357848100507,Hawkish
대출보증/NNG,62,17,79,2.377992400761087,Hawkish
부동산/NNG;활성화/NNG,12,5,17,1.5648724185653602,Hawkish
추락/NNG,187,45,232,2.709547613627059,Hawkish
할부/NNG,285,36,321,5.161905547351015,Hawkish
수상자/NNG,27,12,39,1.467067892405025,Hawkish
촘촘/NNG,35,8,43,2.852632013009772,Hawkish
야권/NNG,96,14,110,4.471064053043887,Hawkish
만들/VV,1326,624,1950,1.3855641206047462,Hawkish
대출/NNG;일시적/VAX,16,1,17,10.432482790435737,Hawkish
동력인/NNG,23,2,25,7.498347005625686,Hawkish
트림/NNG,15,2,17,4.890226308016751,Hawkish
유예/NNG;금리/NNG;인하/NNG,34,1,35,22.16902592967594,Hawkish
오래/NNG,14,7,21,1.3040603488044669,Hawkish
예상/NNG;강하/VA,70,19,89,2.402216432008229,Hawkish
강압/NNG,28,1,29,18.256844883262534,Hawkish
갈수록/MAG,427,201,628,1.385158629202755,Hawkish
거래소/NNG,418,141,559,1.9329688858165504,Hawkish
데이비드/NNG,39,10,49,2.542917680168711,Hawkish
전국/NNG,2362,744,3106,2.070020526798489,Hawkish
경기/NNG;전망/NNG;긍정적/VAX,16,5,21,2.0864965580871475,Hawkish
장기물/NNG;순매수/NNG;강화/NNG,26,2,28,8.476392267229036,Hawkish
윤현/NNG,18,1,19,11.736543139240204,Hawkish
수호천사/NNG,22,2,24,7.172331918424569,Hawkish
셀프/NNG,23,2,25,7.498347005625686,Hawkish
낙폭과대/NNG,24,4,28,3.912181046413401,Hawkish
충당금전입액/NNG,51,15,66,2.2169025929675934,Hawkish
메가트렌드/NNG,24,4,28,3.912181046413401,Hawkish
수출/NNG;성장/NNG,34,16,50,1.3855641206047462,Hawkish
주거지/NNG,41,13,54,2.056402857730121,Hawkish
탐방/NNG,31,15,46,1.3475290270979492,Hawkish
시설자금/NNG,70,14,84,3.260150872011168,Hawkish
먹히/VV,17,6,23,1.847418827472995,Hawkish
하락/NNG;막/VV,17,7,24,1.58350185211971,Hawkish
이성/NNG,17,2,19,5.542256482418985,Hawkish
재고관리/NNG,17,4,21,2.7711282412094924,Hawkish
하방/NNG;경직/NNG,27,7,34,2.514973529837186,Hawkish
집값/NNG;안정/NNG,16,8,24,1.304060348804467,Hawkish
만류/NNG,14,6,20,1.521403740271878,Hawkish
전세난/NNG,21,5,26,2.738526732489381,Hawkish
풋옵션/NNG,52,17,69,1.9944452393480083,Hawkish
의욕/NNG,13,5,18,1.6952784534458072,Hawkish
챗봇/NNG,38,14,52,1.7697961876632051,Hawkish
원가/NNG,467,183,650,1.6639239969718198,Hawkish
백스/NNG,26,1,27,16.952784534458072,Hawkish
초고령사회/NNG,14,7,21,1.3040603488044669,Hawkish
시상식/NNG,18,1,19,11.736543139240204,Hawkish
원료/NNG,87,38,125,1.4928059256051136,Hawkish
영업이익/NNG;늘/VV,77,34,111,1.4766565714403523,Hawkish
인턴/NNG,19,2,21,6.194286656821219,Hawkish
남궁/NNG,16,1,17,10.432482790435737,Hawkish
대표주/NNG,14,6,20,1.521403740271878,Hawkish
상용화/NNG,50,16,66,2.03759429500698,Hawkish
제쳤/VV,21,3,24,4.564211220815635,Hawkish
뉘앙스/NNG,18,9,27,1.3040603488044669,Hawkish
비치/NNG,17,4,21,2.7711282412094924,Hawkish
고금리/NNG,4608,1955,6563,1.5368567998186655,Hawkish
마침내/MAG,26,10,36,1.6952784534458072,Hawkish
메이/NNG,24,5,29,3.1297448371307204,Hawkish
임대차/NNG,474,208,682,1.485876455128167,Hawkish
기대/NNG;상회/NNG,21,8,29,1.7115792078058631,Hawkish
안착/NNG,237,99,336,1.56092072053868,Hawkish
동그라미/NNG,18,2,20,5.868271569620101,Hawkish
발행조건/NNG,18,3,21,3.912181046413401,Hawkish
인산철/NNG,13,5,18,1.6952784534458072,Hawkish
임업/NNG,13,5,18,1.6952784534458072,Hawkish
소비자/NNG;물가/NNG;오르/VV,35,11,46,2.0746414640071067,Hawkish
드러나/VV,275,136,411,1.3184433673574574,Hawkish
금융시장/NNG;변동성/NNG;확대/NNG,74,22,96,2.1931924048075127,Hawkish
변동성/NNG;확대/NNG,167,76,243,1.4327505148049078,Hawkish
금융업계/NNG,100,31,131,2.1033231432330117,Hawkish
인플레이션/NNG;낮/VV,27,11,38,1.600437700805482,Hawkish
상환금/NNG,16,3,19,3.477494263478579,Hawkish
커머스/NNG,191,81,272,1.5375032507509456,Hawkish
급물살/NNG,16,5,21,2.0864965580871475,Hawkish
살펴야/VV,42,16,58,1.7115792078058631,Hawkish
위기설/NNG,164,48,212,2.2277697625409645,Hawkish
지표/NNG;실망/NNG,16,1,17,10.432482790435737,Hawkish
물가/NNG;상승률/NNG;내리/VV,19,8,27,1.548571664205305,Hawkish
여력/NNG;둔화/NNG,17,2,19,5.542256482418985,Hawkish
출자전환/NNG,163,30,193,3.542697280918801,Hawkish
관계자/NNG,3789,1806,5595,1.367963638322294,Hawkish
ftse100/NNG,99,33,132,1.9560905232067003,Hawkish
분양시장/NNG,182,81,263,1.465055453595142,Hawkish
성장/NNG;견인/NNG,63,17,80,2.4163471169023945,Hawkish
선례/NNG,20,5,25,2.608120697608934,Hawkish
인컴/NNG,84,18,102,3.0428074805437566,Hawkish
기업/NNG;고금리/NNG,24,5,29,3.1297448371307204,Hawkish
전망/NNG;늘/VV,26,8,34,2.119098066807259,Hawkish
떠올리/VV,16,4,20,2.608120697608934,Hawkish
뇌관/NNG,44,17,61,1.6876075102175454,Hawkish
갈등/NNG,748,363,1111,1.3435773290712691,Hawkish
믹스/NNG,77,33,110,1.521403740271878,Hawkish
고층/NNG,17,7,24,1.58350185211971,Hawkish
들어서야/VV,13,5,18,1.6952784534458072,Hawkish
상품군/NNG,67,15,82,2.9124014456633094,Hawkish
기울인/VV,16,3,19,3.477494263478579,Hawkish
끼얹/VV,65,10,75,4.238196133614518,Hawkish
끈적끈적/MAG,20,5,25,2.608120697608934,Hawkish
장마감후/NNG,187,89,276,1.369995984418176,Hawkish
비용/NNG;하락/NNG,14,6,20,1.521403740271878,Hawkish
공사현장/NNG,28,8,36,2.282105610407817,Hawkish
지킬/VV,38,8,46,3.0971433284106094,Hawkish
생긴다/VV,51,14,65,2.3752527781795645,Hawkish
국토/NNG,189,43,232,2.8659000688842355,Hawkish
릴레이/NNG,25,11,36,1.481886760005076,Hawkish
수락/NNG,38,6,44,4.1295244378808125,Hawkish
배상/NNG,835,75,910,7.259269275011534,Hawkish
채택/NNG,108,54,162,1.3040603488044669,Hawkish
예금보험/NNG,25,9,34,1.811194928895093,Hawkish
색상/NNG,18,3,21,3.912181046413401,Hawkish
전시장/NNG,19,3,22,4.1295244378808125,Hawkish
경기/NNG;회복/NNG;더디/VA,14,5,19,1.8256844883262535,Hawkish
대출/NNG;금리/NNG;인하/NNG,32,16,48,1.304060348804467,Hawkish
농사/NNG,36,1,37,23.473086278480405,Hawkish
공채/NNG,29,5,34,3.7817750115329543,Hawkish
청소/NNG,18,2,20,5.868271569620101,Hawkish
수탁/NNG,86,25,111,2.242983799943683,Hawkish
분양계획/NNG,37,2,39,12.06255822644132,Hawkish
니치/NNG,21,1,22,13.692633662446903,Hawkish
합성/NNG,243,121,364,1.3094490279317583,Hawkish
문재/NNG,27,12,39,1.467067892405025,Hawkish
미분양/NNG;위험/NNG,14,7,21,1.3040603488044669,Hawkish
불어날/VV,19,5,24,2.4777146627284874,Hawkish
중소벤처기업부/NNG,176,49,225,2.3419859325467978,Hawkish
유상증자/NNG,271,80,351,2.208752215787566,Hawkish
블랙아웃/NNG,30,5,35,3.912181046413401,Hawkish
전합니다/VV,19,7,26,1.7697961876632051,Hawkish
다졌/VV,21,7,28,1.9560905232067007,Hawkish
중심지/NNG,43,10,53,2.8037297499296043,Hawkish
응답비중/NNG,17,6,23,1.847418827472995,Hawkish
방침/NNG,857,389,1246,1.4364777878218873,Hawkish
부적절/NNG,44,20,64,1.4344663836849136,Hawkish
옵션시장/NNG,19,1,20,12.388573313642436,Hawkish
수은/NNG,42,18,60,1.5214037402718783,Hawkish
배당금/NNG,314,128,442,1.5995115215804792,Hawkish
프로/NNG,103,38,141,1.7673449464060542,Hawkish
금리/NNG;인하/NNG;전망/NNG;후퇴/NNG,54,11,65,3.200875401610964,Hawkish
금리/NNG;한계/NNG,28,5,33,3.651368976652508,Hawkish
구호/NNG,22,8,30,1.7930829796061425,Hawkish
폐기/NNG,147,49,196,1.9560905232067007,Hawkish
효력/NNG,46,23,69,1.304060348804467,Hawkish
소비/NNG;심리/NNG;저하/NNG,15,2,17,4.890226308016751,Hawkish
상승곡선/NNG,53,16,69,2.1598499527073987,Hawkish
교역조건/NNG,49,18,67,1.7749710303171913,Hawkish
점용료/NNG,73,1,74,47.59820273136305,Hawkish
매출총이익률/NNG,27,6,33,2.9341357848100507,Hawkish
청라/NNG,42,3,45,9.12842244163127,Hawkish
선성/NNG,114,8,122,9.291429985231828,Hawkish
엔저현상/NNG,67,29,96,1.5064145408603329,Hawkish
소상공인/NNG,1807,892,2699,1.3208727860368117,Hawkish
수요/NNG;상승/NNG,25,7,32,2.328679194293691,Hawkish
돌발/NNG,25,11,36,1.481886760005076,Hawkish
악조건/NNG,12,6,18,1.3040603488044669,Hawkish
프랜차이즈/NNG,104,22,126,3.0823244608105584,Hawkish
계획/NNG,4101,1657,5758,1.6137451691150029,Hawkish
심해/NNG,14,6,20,1.521403740271878,Hawkish
초입/NNG,27,6,33,2.9341357848100507,Hawkish
출퇴근/NNG,51,11,62,3.023048990410355,Hawkish
수출/NNG;늘/VV,70,24,94,1.901754675339848,Hawkish
매끄럽/VA,17,5,22,2.216902592967594,Hawkish
비상장/NNG,33,7,40,3.073856536467672,Hawkish
제동/NNG,144,63,207,1.4903546843479625,Hawkish
희소가치/NNG,28,4,32,4.5642112208156345,Hawkish
미군/NNG,15,4,19,2.4451131540083755,Hawkish
빙수/NNG,24,2,26,7.824362092826802,Hawkish
서브프라임/NNG,14,6,20,1.521403740271878,Hawkish
현장방문/NNG,55,6,61,5.976943265353808,Hawkish
채권액/NNG,14,3,17,3.042807480543756,Hawkish
채국/NNG,13,5,18,1.6952784534458072,Hawkish
안겼/VV,16,7,23,1.4903546843479625,Hawkish
불확실성/NNG;높/VV,16,7,23,1.4903546843479625,Hawkish
민생/NNG,999,278,1277,2.3430868497404003,Hawkish
광역/NNG,62,26,88,1.5548411851130184,Hawkish
산위/NNG,14,3,17,3.042807480543756,Hawkish
옥정/NNG,31,10,41,2.021293540646924,Hawkish
대출/NNG;줄/VV;감소/NNG,24,1,25,15.648724185653604,Hawkish
리보금리/NNG,27,9,36,1.9560905232067003,Hawkish
한지/NNG,16,7,23,1.4903546843479625,Hawkish
기분/NNG,40,13,53,2.006246690468411,Hawkish
각도/NNG,14,3,17,3.042807480543756,Hawkish
지로/NNG,27,8,35,2.200601838607538,Hawkish
피봇/NNG,74,23,97,2.097836213294143,Hawkish
지법/NNG,12,5,17,1.5648724185653602,Hawkish
징수/NNG,38,14,52,1.7697961876632051,Hawkish
운송/NNG,399,120,519,2.1680003298874264,Hawkish
납품/NNG,176,71,247,1.6163001506308885,Hawkish
단순평균/NNG,68,22,90,2.0153659936069035,Hawkish
소폭/MAG;완화/NNG,15,7,22,1.3972075165762146,Hawkish
잔존가치/NNG,34,1,35,22.16902592967594,Hawkish
전기요금/NNG,105,42,147,1.6300754360055838,Hawkish
내세운/VV,70,26,96,1.7554658541598596,Hawkish
제조업체/NNG,116,38,154,1.9904079008068185,Hawkish
사무실/NNG,133,58,191,1.4951726413016733,Hawkish
엑시트/NNG,57,16,73,2.322857496307957,Hawkish
베팅/NNG,851,272,1123,2.0399914647658117,Hawkish
이중과세/NNG,14,7,21,1.3040603488044669,Hawkish
실적치/NNG,27,13,40,1.3542165160661772,Hawkish
완화/NNG;선호/NNG,17,6,23,1.847418827472995,Hawkish
경상/NNG;수지/NNG;개선/NNG,14,5,19,1.8256844883262535,Hawkish
비서/NNG,22,10,32,1.4344663836849136,Hawkish
매출원가율/NNG,22,5,27,2.8689327673698277,Hawkish
금리/NNG;인하/NNG;기대/NNG;위축/NNG,29,9,38,2.100986117518308,Hawkish
일원/NNG,173,58,231,1.9448486236480411,Hawkish
최우선변제/NNG,30,1,31,19.560905232067004,Hawkish
유지관리/NNG,12,6,18,1.3040603488044669,Hawkish
검색/NNG,361,173,534,1.3605947569896315,Hawkish
위험자산/NNG;선호/NNG;회복/NNG,15,5,20,1.9560905232067003,Hawkish
부채/NNG;급증/NNG,17,5,22,2.216902592967594,Hawkish
꾀하/VV,63,26,89,1.5799192687438737,Hawkish
소비/NNG;심리/NNG;위축/NNG,111,21,132,3.446445207554663,Hawkish
관계없이/MAG,64,25,89,1.6691972464697178,Hawkish
방어력/NNG,14,7,21,1.3040603488044669,Hawkish
추세선/NNG,13,5,18,1.6952784534458072,Hawkish
공급면적/NNG,18,5,23,2.3473086278480406,Hawkish
우드/NNG,43,16,59,1.7523310937060026,Hawkish
진균/NNG,113,9,122,8.18660107860582,Hawkish
자릿수/NNG,251,120,371,1.363829781458005,Hawkish
지수/NNG;상승/NNG,241,114,355,1.378414666938055,Hawkish
다각도/NNG,47,17,64,1.802671658641469,Hawkish
출발점/NNG,14,3,17,3.042807480543756,Hawkish
깜짝/MAG;성장/NNG,135,19,154,4.6328459760158704,Hawkish
야후/NNG,65,19,84,2.230629544007641,Hawkish
국정/NNG,78,22,100,2.3117433456079186,Hawkish
유휴/NNG,23,9,32,1.6662993345834856,Hawkish
공매/NNG,580,140,720,2.701267865380682,Hawkish
순우/NNG,72,4,76,11.736543139240204,Hawkish
회화/NNG,18,1,19,11.736543139240204,Hawkish
물가/NNG;잡/VV,93,25,118,2.4255522487763086,Hawkish
발족/NNG,36,12,48,1.9560905232067003,Hawkish
이뤄질지/VV,19,5,24,2.4777146627284874,Hawkish
생활안정/NNG,117,31,148,2.460888077582623,Hawkish
전망/NNG;양호/NNG,18,5,23,2.3473086278480406,Hawkish
뉴노멀/NNG,29,8,37,2.363609382208097,Hawkish
투자/NNG;줄/VV,16,8,24,1.304060348804467,Hawkish
컨트롤/NNG,24,8,32,1.9560905232067003,Hawkish
신사업/NNG,154,46,200,2.182883627346608,Hawkish
걸린다/VV,25,7,32,2.328679194293691,Hawkish
견줘/VV,82,31,113,1.7247249774510691,Hawkish
보수/NNG,791,395,1186,1.3057110581067513,Hawkish
설득/NNG,77,23,100,2.182883627346608,Hawkish
모델/NNG,614,305,919,1.3126115642064635,Hawkish
공산품/NNG,26,11,37,1.5411622304052792,Hawkish
내수/NNG;확대/NNG,14,5,19,1.8256844883262535,Hawkish
건설/NNG;수주/NNG;감소/NNG,14,3,17,3.042807480543756,Hawkish
합법/NNG,26,7,33,2.4218263620654388,Hawkish
눌리/VV,16,4,20,2.608120697608934,Hawkish
판매가격/NNG;상승/NNG,17,7,24,1.58350185211971,Hawkish
경쟁입찰/NNG,82,31,113,1.7247249774510691,Hawkish
신주인수권/NNG,14,5,19,1.8256844883262535,Hawkish
환경경영/NNG,17,1,18,11.08451296483797,Hawkish
이전/NNG;금리/NNG;인하/NNG,24,7,31,2.2355320265219434,Hawkish
공정무역/NNG,15,3,18,3.260150872011167,Hawkish
대외/NNG;악재/NNG,25,11,36,1.481886760005076,Hawkish
플러스/NNG;전환/NNG,52,22,74,1.5411622304052792,Hawkish
풍선/NNG,21,4,25,3.4231584156117263,Hawkish
바다/NNG,42,19,61,1.4413298592049375,Hawkish
국제중재/NNG,15,7,22,1.3972075165762146,Hawkish
평상시/NNG,15,6,21,1.6300754360055836,Hawkish
통용/NNG,12,5,17,1.5648724185653602,Hawkish
존속/NNG,21,8,29,1.7115792078058631,Hawkish
관세청/NNG,35,17,52,1.342415064945775,Hawkish
마감일/NNG,27,11,38,1.600437700805482,Hawkish
생산/NNG;늘/VV,43,14,57,2.002664107092574,Hawkish
절반/NNG,760,355,1115,1.3958955846357677,Hawkish
물가/NNG;상승률/NNG;전망/NNG;상향/NNG,14,4,18,2.282105610407817,Hawkish
알짜/NNG,77,24,101,2.0919301428738324,Hawkish
이온/NNG,47,13,60,2.357339861300382,Hawkish
의대/NNG,45,16,61,1.833834865506282,Hawkish
전망/NNG;긍정적/VAX,39,14,53,1.816369771549079,Hawkish
거둬들이/VV,14,5,19,1.8256844883262535,Hawkish
플러그/NNG,17,7,24,1.58350185211971,Hawkish
도소매/NNG,69,24,93,1.8745867514064207,Hawkish
위험/NNG;해소/NNG,38,11,49,2.252467875207716,Hawkish
전망/NNG;높/VA,63,25,88,1.6431160394936284,Hawkish
특허/NNG,59,11,70,3.4972527536119795,Hawkish
산업/NNG;침체/NNG,12,5,17,1.5648724185653602,Hawkish
즉시/NNG,27,6,33,2.9341357848100507,Hawkish
글로벌/NNG;금리/NNG;인상/NNG,23,9,32,1.6662993345834856,Hawkish
하이/NNG,20,8,28,1.6300754360055838,Hawkish
윤창/NNG,111,7,118,10.339335622663988,Hawkish
미뤘/VV,32,9,41,2.318329508985719,Hawkish
대외/NNG;위험/NNG,29,8,37,2.363609382208097,Hawkish
호재성/NNG,13,5,18,1.6952784534458072,Hawkish
어렵/VA;우려/NNG,23,6,29,2.4994490018752287,Hawkish
재개발/NNG,261,70,331,2.431141078842613,Hawkish
매집/NNG,21,10,31,1.3692633662446905,Hawkish
역방향/NNG,25,4,29,4.075188590013959,Hawkish
펀드설정액/NNG,16,3,19,3.477494263478579,Hawkish
부동산/NNG;불확실성/NNG,25,6,31,2.71679239334264,Hawkish
청구/NNG,145,56,201,1.688292415862926,Hawkish
글로벌/NNG;금리/NNG;인하/NNG,54,26,80,1.3542165160661772,Hawkish
노동시장/NNG;강세/NNG,22,6,28,2.3907773061415227,Hawkish
미비/NNG,27,11,38,1.600437700805482,Hawkish
로열티/NNG,20,9,29,1.4489559431160743,Hawkish
가구주/NNG,31,4,35,5.05323385161731,Hawkish
주식자금/NNG,70,32,102,1.426316006504886,Hawkish
고마진/NNG,24,11,35,1.4226112896048728,Hawkish
변함없이/MAG,16,4,20,2.608120697608934,Hawkish
대손율/NNG,26,6,32,2.825464089076345,Hawkish
계정/NNG,138,58,196,1.5513821390949694,Hawkish
소비자동향조사/NNG,50,12,62,2.71679239334264,Hawkish
알리/VV,95,38,133,1.6300754360055838,Hawkish
증발/NNG,63,16,79,2.5673688117087945,Hawkish
경기/NNG;연착륙/NNG,19,9,28,1.3765081459602708,Hawkish
상습/NNG,16,2,18,5.216241395217868,Hawkish
학과/NNG,33,13,46,1.6551535196364389,Hawkish
무역/NNG;위축/NNG,17,2,19,5.542256482418985,Hawkish
점유율/NNG,252,111,363,1.4802847202645302,Hawkish
사이트/NNG,267,124,391,1.4039681981080352,Hawkish
뒤처졌/VV,13,5,18,1.6952784534458072,Hawkish
실적/NNG;하락/NNG,24,9,33,1.738747131739289,Hawkish
노리/VV,199,93,292,1.3952043516778976,Hawkish
비용/NNG;높/VA,28,10,38,1.8256844883262535,Hawkish
물가/NNG;상승/NNG;압박/NNG,25,4,29,4.075188590013959,Hawkish
재단/NNG,197,82,279,1.5664627360639023,Hawkish
현수/NNG,109,7,116,10.153041287120494,Hawkish
낙찰률/NNG,245,79,324,2.0221188952980658,Hawkish
좋아하/VV,13,5,18,1.6952784534458072,Hawkish
영화관/NNG,36,14,50,1.6766490198914574,Hawkish
대출/NNG;영업/NNG;강화/NNG,23,2,25,7.498347005625686,Hawkish
부임/NNG,18,8,26,1.467067892405025,Hawkish
관은/NNG,34,10,44,2.216902592967594,Hawkish
환산손실/NNG,16,1,17,10.432482790435737,Hawkish
절하/NNG;압력/NNG,30,3,33,6.520301744022334,Hawkish
금물/NNG,14,4,18,2.282105610407817,Hawkish
월물간/NNG,15,2,17,4.890226308016751,Hawkish
비정규직/NNG,20,4,24,3.260150872011168,Hawkish
국무총리/NNG,20,9,29,1.4489559431160743,Hawkish
실점/NNG,21,3,24,4.564211220815635,Hawkish
과점/NNG,56,9,65,4.0570766407250085,Hawkish
조명/NNG,50,23,73,1.4174569008744209,Hawkish
실물/NNG;경제/NNG;불확실성/NNG,35,7,42,3.260150872011168,Hawkish
수요자/NNG;많/VA,12,6,18,1.3040603488044669,Hawkish
코스/NNG,25,5,30,3.260150872011168,Hawkish
우울/NNG,16,7,23,1.4903546843479625,Hawkish
오일쇼크/NNG,81,16,97,3.3009027579113077,Hawkish
고객군/NNG,20,4,24,3.260150872011168,Hawkish
농산물/NNG;가격/NNG;상승/NNG,57,10,67,3.716571994092731,Hawkish
쌍둥이적자/NNG,26,5,31,3.3905569068916144,Hawkish
풍선효과/NNG,29,10,39,1.8908875057664771,Hawkish
유찰/NNG,262,43,305,3.9728350161252366,Hawkish
띄우/VV,23,4,27,3.749173502812843,Hawkish
투자분석/NNG,21,7,28,1.9560905232067007,Hawkish
두드리/VV,24,12,36,1.3040603488044669,Hawkish
홍제/NNG,15,6,21,1.6300754360055836,Hawkish
레버리지론/NNG,67,27,94,1.6180008031462831,Hawkish
폐지/NNG,682,266,948,1.671746537377155,Hawkish
부동산/NNG;경기/NNG;하락/NNG,39,8,47,3.1786471002108883,Hawkish
물가/NNG;전망/NNG;불확실성/NNG,38,4,42,6.194286656821219,Hawkish
광역시/NNG,220,96,316,1.494235816338452,Hawkish
무역협회/NNG,41,7,48,3.819033878641653,Hawkish
시가평가/NNG,22,1,23,14.344663836849138,Hawkish
국고채/NNG;스프레드/NNG;축소/NNG,48,10,58,3.1297448371307204,Hawkish
채무보증/NNG,37,15,52,1.6083410968588423,Hawkish
근로자의날/NNG,15,4,19,2.4451131540083755,Hawkish
형제/NNG,52,13,65,2.608120697608934,Hawkish
기대/NNG;웃돌/VV,26,10,36,1.6952784534458072,Hawkish
공실/NNG,146,58,204,1.6413173355642432,Hawkish
플레이어/NNG,53,9,62,3.839733249257597,Hawkish
영업손실/NNG,227,63,290,2.349378564909635,Hawkish
인플레이션/NNG;높/VA,21,10,31,1.3692633662446905,Hawkish
신산업/NNG,64,30,94,1.3909977053914315,Hawkish
신용판매/NNG,38,8,46,3.0971433284106094,Hawkish
녹색채권/NNG,87,24,111,2.363609382208097,Hawkish
사그라들/VV,32,14,46,1.4903546843479625,Hawkish
中企/NNG,12,5,17,1.5648724185653602,Hawkish
빗장/NNG,24,7,31,2.2355320265219434,Hawkish
복선/NNG,22,5,27,2.8689327673698277,Hawkish
현재생활형편/NNG,17,6,23,1.847418827472995,Hawkish
지식재산권/NNG,26,8,34,2.119098066807259,Hawkish
담보권/NNG,15,7,22,1.3972075165762146,Hawkish
임금/NNG;인상/NNG,57,19,76,1.9560905232067003,Hawkish
세기/NNG,48,20,68,1.5648724185653602,Hawkish
이어가기/NNG,29,8,37,2.363609382208097,Hawkish
보타/NNG,17,4,21,2.7711282412094924,Hawkish
최적/NNG,267,77,344,2.260935799550602,Hawkish
채워야/VV,22,4,26,3.5861659592122845,Hawkish
마케팅/NNG,369,154,523,1.5623320412624944,Hawkish
금리/NNG;상승/NNG;경기/NNG;침체/NNG,17,1,18,11.08451296483797,Hawkish
좌초/NNG,33,4,37,5.379248938818426,Hawkish
중고차/NNG,163,37,200,2.872457254799029,Hawkish
중견/NNG;기업/NNG;성장/NNG,15,6,21,1.6300754360055836,Hawkish
지수/NNG;방어/NNG,19,5,24,2.4777146627284874,Hawkish
평화/NNG,37,17,54,1.4191244972283903,Hawkish
금리/NNG;인하/NNG;없/VA,77,34,111,1.4766565714403523,Hawkish
방법론/NNG,18,7,25,1.6766490198914574,Hawkish
공모펀드/NNG,59,28,87,1.3739207246332776,Hawkish
땡겨/VV,28,6,34,3.042807480543756,Hawkish
은행세/NNG,22,1,23,14.344663836849138,Hawkish
트랙터/NNG,96,1,97,62.59489674261442,Hawkish
내수/NNG;부정적/VAX,16,4,20,2.608120697608934,Hawkish
하락/NNG;축소/NNG,22,11,33,1.3040603488044669,Hawkish
윤지/NNG,37,14,51,1.7232226037773315,Hawkish
책무/NNG,70,25,95,1.8256844883262535,Hawkish
라이선스/NNG,48,22,70,1.4226112896048728,Hawkish
전세/NNG;상승/NNG,14,6,20,1.521403740271878,Hawkish
공백/NNG,110,38,148,1.8874557680064656,Hawkish
위험/NNG;없/VA,33,12,45,1.793082979606142,Hawkish
하락/NNG;없/VA,14,3,17,3.042807480543756,Hawkish
세분화/NNG,118,48,166,1.6029075120721574,Hawkish
성적/NNG,161,63,224,1.6662993345834856,Hawkish
금융센터/NNG,75,33,108,1.481886760005076,Hawkish
능동/NNG,29,12,41,1.575739588138731,Hawkish
손해율/NNG,75,5,80,9.780452616033502,Hawkish
캣본드/NNG,44,1,45,28.68932767369828,Hawkish
전언/NNG,22,11,33,1.3040603488044669,Hawkish
후생/NNG,13,5,18,1.6952784534458072,Hawkish
지칭/NNG,18,5,23,2.3473086278480406,Hawkish
음식료품/NNG,99,36,135,1.793082979606142,Hawkish
흑자/NNG;전환/NNG,34,10,44,2.216902592967594,Hawkish
면부/NNG,28,1,29,18.256844883262534,Hawkish
대지면적/NNG,36,16,52,1.467067892405025,Hawkish
한껏/MAG,27,11,38,1.600437700805482,Hawkish
기획/NNG,263,100,363,1.714839358677874,Hawkish
경제/NNG;호조/NNG,39,16,55,1.589323550105444,Hawkish
뱅킹/NNG,162,67,229,1.5765505709427137,Hawkish
응찰금액/NNG,18,8,26,1.467067892405025,Hawkish
여력/NNG;확보/NNG,32,14,46,1.4903546843479625,Hawkish
장바구니/NNG,32,15,47,1.3909977053914315,Hawkish
높/VA;수출/NNG;증가/NNG,51,11,62,3.023048990410355,Hawkish
대중/NNG,188,77,265,1.591969776462596,Hawkish
부동산/NNG;호황/NNG,18,8,26,1.467067892405025,Hawkish
증한/VA,21,7,28,1.9560905232067007,Hawkish
중소기업금융/NNG,93,42,135,1.4437811004620884,Hawkish
물류비용/NNG,17,4,21,2.7711282412094924,Hawkish
환위험/NNG,47,15,62,2.043027879793665,Hawkish
충당부채/NNG,254,13,267,12.739666484474409,Hawkish
이자이익/NNG,526,73,599,4.698190023774997,Hawkish
계절요인/NNG,16,8,24,1.304060348804467,Hawkish
감세정책/NNG,86,28,114,2.002664107092574,Hawkish
통지/NNG,45,22,67,1.333698084004569,Hawkish
골드바/NNG,89,42,131,1.3816829886142563,Hawkish
전례/NNG,49,24,73,1.3312282727378937,Hawkish
세트/NNG,45,8,53,3.667669731012564,Hawkish
조례/NNG,54,7,61,5.029947059674372,Hawkish
가늠자/NNG,19,5,24,2.4777146627284874,Hawkish
노원/NNG,58,18,76,2.100986117518308,Hawkish
졸업/NNG,96,31,127,2.0191902175036907,Hawkish
우형/NNG,34,3,37,7.38967530989198,Hawkish
드러났/VV,75,26,101,1.880856272314135,Hawkish
수직/NNG,47,17,64,1.802671658641469,Hawkish
장해/NNG,48,7,55,4.471064053043887,Hawkish
도발/NNG,53,21,74,1.6455999639675416,Hawkish
금속/NNG,226,108,334,1.36443351310097,Hawkish
골칫거리/NNG,14,5,19,1.8256844883262535,Hawkish
양극/NNG,63,23,86,1.78599569510177,Hawkish
간주/NNG,111,42,153,1.7232226037773315,Hawkish
좌장/NNG,31,8,39,2.526616925808655,Hawkish
플러그인/NNG,25,4,29,4.075188590013959,Hawkish
가격/NNG;전고점/NNG,30,11,41,1.7782641120060911,Hawkish
지하/NNG,64,23,87,1.8143448331192584,Hawkish
수출/NNG;좋/VA,27,3,30,5.868271569620101,Hawkish
로리/NNG,12,6,18,1.3040603488044669,Hawkish
뚫리/VV,18,8,26,1.467067892405025,Hawkish
유한책임/NNG,16,1,17,10.432482790435737,Hawkish
금융지원/NNG;확대/NNG,31,9,40,2.2458817118299157,Hawkish
호흡/NNG,37,15,52,1.6083410968588423,Hawkish
유상/NNG,13,4,17,2.119098066807259,Hawkish
중구/NNG,162,67,229,1.5765505709427137,Hawkish
물가/NNG;압력/NNG;완화/NNG,15,6,21,1.6300754360055836,Hawkish
서쪽/NNG,14,3,17,3.042807480543756,Hawkish
저평가/NNG,387,185,572,1.3639766351008884,Hawkish
마린/NNG,174,45,219,2.521183341021969,Hawkish
자연환경/NNG,21,4,25,3.4231584156117263,Hawkish
섞인/VV,29,14,43,1.350633932690341,Hawkish
관철/NNG,17,6,23,1.847418827472995,Hawkish
물가/NNG;오르/VV,136,61,197,1.4537066183394058,Hawkish
분할매수/NNG,57,17,74,2.186218820054548,Hawkish
절실히/MAG,15,4,19,2.4451131540083755,Hawkish
리플레이션/NNG,17,3,20,3.69483765494599,Hawkish
바르/VA,15,2,17,4.890226308016751,Hawkish
프로퍼티/NNG,24,2,26,7.824362092826802,Hawkish
중고/NNG,48,19,67,1.6472341248056426,Hawkish
재해/NNG,32,15,47,1.3909977053914315,Hawkish
gdp/NNG;회복/NNG,16,1,17,10.432482790435737,Hawkish
고삐/NNG,32,14,46,1.4903546843479625,Hawkish
전세가격/NNG;강세/NNG,23,4,27,3.749173502812843,Hawkish
파라/NNG,17,3,20,3.69483765494599,Hawkish
상계/NNG,74,21,95,2.297630138369775,Hawkish
부수업무/NNG,21,9,30,1.5214037402718783,Hawkish
고르/VV,86,38,124,1.4756472368050548,Hawkish
판매/NNG;호조/NNG,42,16,58,1.7115792078058631,Hawkish
부동산/NNG;pf/NNG;우려/NNG,29,4,33,4.727218764416193,Hawkish
들어온다/VV,17,4,21,2.7711282412094924,Hawkish
냉난방/NNG,25,5,30,3.260150872011168,Hawkish
심리/NNG;긍정적/VAX,20,4,24,3.260150872011168,Hawkish
용도지역/NNG,31,13,44,1.5548411851130184,Hawkish
청산대상/NNG,12,5,17,1.5648724185653602,Hawkish
대출/NNG;부담/NNG;증가/NNG,15,2,17,4.890226308016751,Hawkish
개관/NNG,38,17,55,1.4574792133696983,Hawkish
수산/NNG,29,4,33,4.727218764416193,Hawkish
보증서/NNG,180,28,208,4.191622549728645,Hawkish
중역/NNG,13,4,17,2.119098066807259,Hawkish
수익/NNG;방어/NNG,16,3,19,3.477494263478579,Hawkish
탑재/NNG,176,34,210,3.375215020435091,Hawkish
조업일수/NNG,75,20,95,2.4451131540083755,Hawkish
스탠더드/NNG,34,11,45,2.0153659936069035,Hawkish
고스란히/MAG,81,26,107,2.031324774099266,Hawkish
내부통제/NNG;강화/NNG,29,6,35,3.151479176277462,Hawkish
사전채무조정/NNG,26,1,27,16.952784534458072,Hawkish
통념/NNG,15,4,19,2.4451131540083755,Hawkish
fed/NNG;금리/NNG;인하/NNG;기대/NNG;높/VA,19,4,23,3.0971433284106094,Hawkish
각자/MAG,36,16,52,1.467067892405025,Hawkish
개장전/NNG,71,32,103,1.4466919494549555,Hawkish
용량/NNG,53,25,78,1.3823039697327348,Hawkish
센터/NNG,820,369,1189,1.4489559431160746,Hawkish
장벽/NNG,33,15,48,1.4344663836849136,Hawkish
기정사실/NNG,33,16,49,1.3448122347046063,Hawkish
부동/NNG,434,161,595,1.7576465570842814,Hawkish
배당수익률/NNG,164,36,200,2.970359683387952,Hawkish
고위/NNG,140,57,197,1.601477621338819,Hawkish
브랜드이미지/NNG,13,4,17,2.119098066807259,Hawkish
공적연금/NNG,20,10,30,1.304060348804467,Hawkish
감원/NNG,65,20,85,2.119098066807259,Hawkish
메기/NNG,36,4,40,5.868271569620101,Hawkish
투기/NNG,175,79,254,1.4443706394986184,Hawkish
가입일/NNG,21,1,22,13.692633662446903,Hawkish
축제/NNG,120,20,140,3.912181046413401,Hawkish
인플레이션/NNG;물가/NNG;상승/NNG;압력/NNG,23,8,31,1.8745867514064212,Hawkish
공격/NNG,610,248,858,1.6037838967151712,Hawkish
투자/NNG;높/VA,25,1,26,16.300754360055837,Hawkish
비금속/NNG,49,15,64,2.129965236380629,Hawkish
지형/NNG,61,19,80,2.093360033607171,Hawkish
드리/VV,165,62,227,1.7352415931672345,Hawkish
내수주/NNG,17,3,20,3.69483765494599,Hawkish
방공/NNG,13,6,19,1.4127320445381726,Hawkish
파티/NNG,24,6,30,2.6081206976089337,Hawkish
불안/NNG;해소/NNG,23,10,33,1.499669401125137,Hawkish
돈/NNG;줄/VV,12,5,17,1.5648724185653602,Hawkish
신발/NNG,41,5,46,5.346647430098314,Hawkish
극명/NNG,20,9,29,1.4489559431160743,Hawkish
내몰린/VV,18,8,26,1.467067892405025,Hawkish
발효/NNG,25,11,36,1.481886760005076,Hawkish
판도/NNG,24,7,31,2.2355320265219434,Hawkish
영업이익/NNG,2968,946,3914,2.0456929784628213,Hawkish
시동/NNG,42,14,56,1.9560905232067007,Hawkish
이자/NNG;경감/NNG,20,1,21,13.04060348804467,Hawkish
꼽혔/VV,156,76,232,1.3383777264045846,Hawkish
초원/NNG,19,2,21,6.194286656821219,Hawkish
고문/NNG,51,14,65,2.3752527781795645,Hawkish
돌연/MAG,15,6,21,1.6300754360055836,Hawkish
경기/NNG;점차/MAG;회복/NNG,12,5,17,1.5648724185653602,Hawkish
시름/NNG,36,9,45,2.6081206976089337,Hawkish
거슬러/VV,13,4,17,2.119098066807259,Hawkish
양곡관리법/NNG,15,3,18,3.260150872011167,Hawkish
부동산/NNG;회복/NNG,52,26,78,1.304060348804467,Hawkish
건설/NNG;투자/NNG;증가/NNG,22,4,26,3.5861659592122845,Hawkish
제련소/NNG,21,3,24,4.564211220815635,Hawkish
전금/NNG,21,3,24,4.564211220815635,Hawkish
실적/NNG;충족/NNG,14,3,17,3.042807480543756,Hawkish
개별종목/NNG,80,36,116,1.4489559431160743,Hawkish
입주/NNG,1136,418,1554,1.77202458880607,Hawkish
공급/NNG;위축/NNG,28,4,32,4.5642112208156345,Hawkish
회수/NNG,613,212,825,1.8853514005121184,Hawkish
연금저축/NNG,88,36,124,1.5938515374276818,Hawkish
수익성/NNG;확보/NNG,35,10,45,2.282105610407817,Hawkish
받아들인/VV,16,4,20,2.608120697608934,Hawkish
토지신탁/NNG,16,5,21,2.0864965580871475,Hawkish
국민/NNG;부담/NNG,22,4,26,3.5861659592122845,Hawkish
기업/NNG;부채/NNG;증가/NNG,23,2,25,7.498347005625686,Hawkish
매파/NNG;인하/NNG,24,2,26,7.824362092826802,Hawkish
재정/NNG;적자/NNG;줄/VV,22,4,26,3.5861659592122845,Hawkish
비용/NNG;크/VV,15,4,19,2.4451131540083755,Hawkish
중소기업자금/NNG,30,5,35,3.912181046413401,Hawkish
결제일/NNG,18,5,23,2.3473086278480406,Hawkish
기세/NNG,27,7,34,2.514973529837186,Hawkish
가격/NNG;안정/NNG,68,16,84,2.7711282412094924,Hawkish
항셍/NNG,72,24,96,1.9560905232067003,Hawkish
순회/NNG,19,1,20,12.388573313642436,Hawkish
진료비/NNG,12,6,18,1.3040603488044669,Hawkish
청사진/NNG,40,12,52,2.173433914674112,Hawkish
기부/NNG,70,29,99,1.573865938212288,Hawkish
건설공사/NNG,30,13,43,1.504685017851308,Hawkish
변액/NNG,22,1,23,14.344663836849138,Hawkish
사들이/VV,255,107,362,1.5539036866595286,Hawkish
변모/NNG,14,7,21,1.3040603488044669,Hawkish
경제/NNG;좋/VA,30,14,44,1.3972075165762146,Hawkish
경제장관회의/NNG,103,8,111,8.394888495428757,Hawkish
정육/NNG,26,9,35,1.8836427260508968,Hawkish
내수/NNG;부진/NNG;완화/NNG,16,1,17,10.432482790435737,Hawkish
냉각/NNG,224,102,326,1.4319094026088266,Hawkish
금리/NNG;인하/NNG;기대/NNG;하락/NNG,23,11,34,1.36333581920467,Hawkish
소비자/NNG;피해/NNG,27,7,34,2.514973529837186,Hawkish
지수/NNG;소폭/MAG;상승/NNG,16,6,22,1.7387471317392895,Hawkish
단호/NNG,20,7,27,1.8629433554349528,Hawkish
기성/NNG,114,48,162,1.5485716642053045,Hawkish
중국인/NNG,52,17,69,1.9944452393480083,Hawkish
사업장/NNG,2436,739,3175,2.149317327258242,Hawkish
탈환/NNG,74,37,111,1.304060348804467,Hawkish
수익성/NNG;악화/NNG,97,43,140,1.470858765512015,Hawkish
상징/NNG,89,34,123,1.7067848682881994,Hawkish
액셀러레이터/NNG,32,2,34,10.432482790435737,Hawkish
법무부/NNG,42,5,47,5.477053464978762,Hawkish
전망/NNG;상향/NNG,103,39,142,1.7220284093187193,Hawkish
달려/VV,45,15,60,1.9560905232067003,Hawkish
깔린/VV,14,4,18,2.282105610407817,Hawkish
안전장치/NNG,14,7,21,1.3040603488044669,Hawkish
와트/NNG,13,5,18,1.6952784534458072,Hawkish
금리/NNG;부담/NNG;완화/NNG,29,14,43,1.350633932690341,Hawkish
폭우/NNG,26,8,34,2.119098066807259,Hawkish
개별소비세/NNG,50,24,74,1.3583961966713198,Hawkish
가계/NNG;대출/NNG;늘/VV,22,11,33,1.3040603488044669,Hawkish
발행주식수/NNG,14,4,18,2.282105610407817,Hawkish
무협/NNG,36,10,46,2.3473086278480406,Hawkish
단기물/NNG;금리/NNG;스프레드/NNG;부담/NNG,18,2,20,5.868271569620101,Hawkish
투자/NNG;가격/NNG;높/VA,12,5,17,1.5648724185653602,Hawkish
우성/NNG,16,3,19,3.477494263478579,Hawkish
갑작/MAG,96,47,143,1.331806313672647,Hawkish
쓰러지/VV,13,4,17,2.119098066807259,Hawkish
연차/NNG,40,18,58,1.4489559431160743,Hawkish
모아/VV,293,115,408,1.661259487824821,Hawkish
요동치/VV,64,24,88,1.7387471317392895,Hawkish
대수/NNG,35,17,52,1.342415064945775,Hawkish
사의/NNG,68,33,101,1.343577329071269,Hawkish
해수부/NNG,60,1,61,39.12181046413401,Hawkish
내국/NNG,43,15,58,1.869153166619736,Hawkish
병역/NNG,188,2,190,61.290836393809954,Hawkish
고장/NNG,16,2,18,5.216241395217868,Hawkish
계양/NNG,27,9,36,1.9560905232067003,Hawkish
소재부품/NNG,53,10,63,3.4557599243318378,Hawkish
완납/NNG,20,2,22,6.520301744022335,Hawkish
문턱/NNG,292,116,408,1.6413173355642432,Hawkish
가격/NNG,12828,6320,19148,1.3234561831063056,Hawkish
둔화/NNG;멈추/VV,16,3,19,3.477494263478579,Hawkish
수요/NNG;확충/NNG,15,4,19,2.4451131540083755,Hawkish
기업/NNG;실적/NNG;호조/NNG,41,9,50,2.970359683387952,Hawkish
행연/NNG,23,9,32,1.6662993345834856,Hawkish
학원/NNG,69,30,99,1.4996694011251368,Hawkish
챙기/VV,48,23,71,1.3607586248394437,Hawkish
좀처럼/MAG,182,89,271,1.3333650757438933,Hawkish
진료/NNG,36,7,43,3.353298039782915,Hawkish
표류/NNG,18,8,26,1.467067892405025,Hawkish
농산물/NNG;가격/NNG;급등/NNG,32,6,38,3.477494263478579,Hawkish
배후/NNG,73,19,92,2.505168564808581,Hawkish
투자회사/NNG,72,31,103,1.514392663127768,Hawkish
골자/NNG,136,59,195,1.5029848087915891,Hawkish
순유입세/NNG,15,6,21,1.6300754360055836,Hawkish
동력/NNG,360,93,453,2.523987771879614,Hawkish
그늘/NNG,13,4,17,2.119098066807259,Hawkish
키트/NNG,22,3,25,4.7815546122830455,Hawkish
차액결제선물환/NNG,96,46,142,1.3607586248394437,Hawkish
가계/NNG;대출/NNG;안정/NNG,14,6,20,1.521403740271878,Hawkish
파산/NNG,291,145,436,1.3085571086279306,Hawkish
라인/NNG,317,141,458,1.465911810535518,Hawkish
거쳐야/VV,40,9,49,2.8979118862321487,Hawkish
위장/NNG,13,4,17,2.119098066807259,Hawkish
보장형/NNG,36,11,47,2.133916934407309,Hawkish
명성/NNG,22,11,33,1.3040603488044669,Hawkish
중소형사/NNG,73,20,93,2.3799101365681525,Hawkish
콜라/NNG,12,6,18,1.3040603488044669,Hawkish
작품/NNG,49,7,56,4.5642112208156345,Hawkish
개통/NNG,199,90,289,1.441711163400494,Hawkish
캐스터/NNG,48,24,72,1.3040603488044669,Hawkish
욕실/NNG,29,4,33,4.727218764416193,Hawkish
수당/NNG,43,21,64,1.335109404728383,Hawkish
수산업/NNG,19,1,20,12.388573313642436,Hawkish
부동산투자신탁/NNG,29,11,40,1.7189886416058884,Hawkish
대항마/NNG,17,8,25,1.3855641206047462,Hawkish
공사비/NNG,1119,509,1628,1.4334415818390949,Hawkish
후원/NNG,36,14,50,1.6766490198914574,Hawkish
숨기/VV,14,3,17,3.042807480543756,Hawkish
임차료/NNG,29,13,42,1.454528850589598,Hawkish
전세시장/NNG,119,34,153,2.282105610407817,Hawkish
점포수/NNG,46,9,55,3.332598669166971,Hawkish
통화/NNG;절하/NNG,15,6,21,1.6300754360055836,Hawkish
정부계획/NNG,17,1,18,11.08451296483797,Hawkish
재무/NNG;건전성/NNG;확보/NNG,22,2,24,7.172331918424569,Hawkish
판매수수료/NNG;증가/NNG,17,1,18,11.08451296483797,Hawkish
성장국면/NNG,28,10,38,1.8256844883262535,Hawkish
쏠릴/VV,31,10,41,2.021293540646924,Hawkish
실적/NNG;오르/VV,30,7,37,2.794415033152429,Hawkish
배럴/NNG,951,379,1330,1.636096822840433,Hawkish
현직/NNG,19,3,22,4.1295244378808125,Hawkish
애플리케이션/NNG,105,43,148,1.5921667049356865,Hawkish
입찰가/NNG,33,8,41,2.689624469409213,Hawkish
공무원연금/NNG,24,5,29,3.1297448371307204,Hawkish
영업이익/NNG;오르/VV,32,2,34,10.432482790435737,Hawkish
고속/NNG;성장/NNG,26,7,33,2.4218263620654388,Hawkish
순이익률/NNG,20,5,25,2.608120697608934,Hawkish
특례/NNG,635,299,934,1.384746357008088,Hawkish
부동산/NNG;pf/NNG;위험/NNG,73,23,96,2.0694870752766543,Hawkish
고분/NNG,46,12,58,2.4994490018752287,Hawkish
알림/VV,50,19,69,1.7158688800058777,Hawkish
오른쪽/NNG,26,12,38,1.4127320445381726,Hawkish
상연/NNG,19,1,20,12.388573313642436,Hawkish
이중침체/NNG,41,16,57,1.6708273219057237,Hawkish
룰렛/NNG,18,7,25,1.6766490198914574,Hawkish
전망/NNG;상승/NNG,61,24,85,1.6572433599390102,Hawkish
중소기업중앙회/NNG,121,43,164,1.8347825837830292,Hawkish
만선/NNG,70,4,74,11.410528052039089,Hawkish
주유/NNG,19,2,21,6.194286656821219,Hawkish
백금/NNG,40,6,46,4.346867829348224,Hawkish
국제/NNG;유가/NNG;급등/NNG,80,16,96,3.260150872011168,Hawkish
시행사/NNG,348,140,488,1.620760719228409,Hawkish
대손비용/NNG,182,58,240,2.046025719675974,Hawkish
사무국/NNG,17,3,20,3.69483765494599,Hawkish
창업/NNG,548,159,707,2.2472486513988925,Hawkish
예상/NNG;넘/VV,128,53,181,1.574714383461998,Hawkish
점수/NNG,501,242,743,1.3498641213864422,Hawkish
부정/NNG,100,42,142,1.552452796195794,Hawkish
호조/NNG,1518,761,2279,1.3006331205553094,Hawkish
순식간/NNG,20,9,29,1.4489559431160743,Hawkish
상환금액/NNG,44,3,47,9.563109224566093,Hawkish
브리지론/NNG,168,17,185,6.44359231173972,Hawkish
인스트루먼트/NNG,30,4,34,4.890226308016751,Hawkish
갈릴/VV,28,7,35,2.6081206976089337,Hawkish
착공/NNG,659,289,948,1.4868092904189336,Hawkish
촘촘히/MAG,15,2,17,4.890226308016751,Hawkish
중신/NNG,50,6,56,5.433584786685279,Hawkish
수기/NNG,32,4,36,5.216241395217868,Hawkish
모인다/VV,31,13,44,1.5548411851130184,Hawkish
성장/NNG;전환/NNG,12,6,18,1.3040603488044669,Hawkish
조위/NNG,62,2,64,20.21293540646924,Hawkish
해약/NNG,74,30,104,1.6083410968588423,Hawkish
포부/NNG,44,11,55,2.6081206976089337,Hawkish
미션/NNG,39,14,53,1.816369771549079,Hawkish
규제당국/NNG,41,12,53,2.2277697625409645,Hawkish
미침/VV,14,7,21,1.3040603488044669,Hawkish
네트워킹/NNG,26,10,36,1.6952784534458072,Hawkish
장밋빛/NNG,55,18,73,1.9923144217846025,Hawkish
이티/NNG,22,7,29,2.049237690978448,Hawkish
roe/NNG,273,77,350,2.3117433456079186,Hawkish
법무/NNG,14,4,18,2.282105610407817,Hawkish
점포망/NNG,20,2,22,6.520301744022335,Hawkish
수요/NNG;줄/VV,68,34,102,1.304060348804467,Hawkish
손익/NNG;증가/NNG,20,3,23,4.346867829348224,Hawkish
투자비용/NNG,57,19,76,1.9560905232067003,Hawkish
과일/NNG,170,43,213,2.5777937127530164,Hawkish
사와/NNG,30,13,43,1.504685017851308,Hawkish
비급여/NNG,35,1,36,22.82105610407817,Hawkish
정면/NNG,14,6,20,1.521403740271878,Hawkish
검단/NNG,78,12,90,4.238196133614518,Hawkish
내걸/VV,74,29,103,1.6638011346815615,Hawkish
인플레이션/NNG;우려/NNG;크/VV,18,1,19,11.736543139240204,Hawkish
증가분/NNG,62,15,77,2.6950580541958984,Hawkish
수인/NNG,14,3,17,3.042807480543756,Hawkish
경제/NNG;성장/NNG,184,74,258,1.6212642174325806,Hawkish
임시투자세액공제/NNG,17,5,22,2.216902592967594,Hawkish
하이테크/NNG,20,3,23,4.346867829348224,Hawkish
ff/NNG;금리선물/NNG;시장/NNG;금리/NNG;인하/NNG,15,4,19,2.4451131540083755,Hawkish
체불/NNG,286,2,288,93.2403149395194,Hawkish
실명/NNG,17,3,20,3.69483765494599,Hawkish
도매업/NNG,15,3,18,3.260150872011167,Hawkish
해협/NNG,145,43,188,2.198706402054043,Hawkish
생활권/NNG,57,19,76,1.9560905232067003,Hawkish
접도/NNG,14,5,19,1.8256844883262535,Hawkish
실적/NNG;악화/NNG,102,49,151,1.3572873018168945,Hawkish
일반회계/NNG,14,3,17,3.042807480543756,Hawkish
자본시장법/NNG,31,14,45,1.4437811004620884,Hawkish
협력사/NNG,85,34,119,1.6300754360055838,Hawkish
돌아온/VV,53,16,69,2.1598499527073987,Hawkish
광장/NNG,94,30,124,2.043027879793665,Hawkish
이웃/NNG,30,12,42,1.6300754360055836,Hawkish
국채/NNG;금리/NNG;안정/NNG,16,6,22,1.7387471317392895,Hawkish
자율규제/NNG,18,2,20,5.868271569620101,Hawkish
생활형편/NNG,21,3,24,4.564211220815635,Hawkish
정파/NNG,18,7,25,1.6766490198914574,Hawkish
출자금/NNG,51,12,63,2.771128241209492,Hawkish
고착화/NNG,186,90,276,1.3475290270979492,Hawkish
주택분양/NNG,18,4,22,2.9341357848100507,Hawkish
최대한도/NNG,26,5,31,3.3905569068916144,Hawkish
소비자/NNG;물가/NNG;상승/NNG;둔화/NNG,34,2,36,11.08451296483797,Hawkish
신용/NNG;개선/NNG,20,8,28,1.6300754360055838,Hawkish
리언/NNG,22,6,28,2.3907773061415227,Hawkish
하락/NNG;떨어/VV,17,8,25,1.3855641206047462,Hawkish
액면분할/NNG,198,82,280,1.5744143235566126,Hawkish
후임/NNG,23,8,31,1.8745867514064212,Hawkish
위반/NNG,334,66,400,3.299667852277969,Hawkish
갤러리/NNG,62,8,70,5.05323385161731,Hawkish
금리/NNG;인하/NNG;기대/NNG;낮/VA,46,17,63,1.7643169425001612,Hawkish
증시대기자금/NNG,33,11,44,1.9560905232067003,Hawkish
답답/NNG,29,13,42,1.454528850589598,Hawkish
가격/NNG;급락/NNG,48,7,55,4.471064053043887,Hawkish
이익률/NNG;개선/NNG,16,2,18,5.216241395217868,Hawkish
다우존스/NNG,272,118,390,1.5029848087915891,Hawkish
종금사/NNG,22,6,28,2.3907773061415227,Hawkish
성립/NNG,84,13,97,4.213118049983663,Hawkish
수의계약/NNG,65,6,71,7.063660222690863,Hawkish
다가구주택/NNG,31,10,41,2.021293540646924,Hawkish
수익성/NNG;확대/NNG,73,4,77,11.899550682840763,Hawkish
농지/NNG,20,3,23,4.346867829348224,Hawkish
기본공제/NNG,30,6,36,3.260150872011167,Hawkish
부실/NNG;우려/NNG,79,35,114,1.4717252507936127,Hawkish
명문/NNG,43,11,54,2.548845227208731,Hawkish
종사자수/NNG,13,4,17,2.119098066807259,Hawkish
일명/NNG,38,17,55,1.4574792133696983,Hawkish
회비/NNG,33,7,40,3.073856536467672,Hawkish
특례시/NNG,40,4,44,6.520301744022335,Hawkish
학계/NNG,61,30,91,1.325794687951208,Hawkish
견디/VV,80,30,110,1.7387471317392893,Hawkish
일정비율/NNG,36,10,46,2.3473086278480406,Hawkish
분수령/NNG,45,5,50,5.868271569620102,Hawkish
수요/NNG;둔화/NNG;우려/NNG,21,9,30,1.5214037402718783,Hawkish
격주/NNG,18,7,25,1.6766490198914574,Hawkish
부침/NNG,36,10,46,2.3473086278480406,Hawkish
통신요금/NNG,50,17,67,1.9177358070653927,Hawkish
높이/NNG,15,4,19,2.4451131540083755,Hawkish
가증/NNG,32,1,33,20.864965580871477,Hawkish
주요인/NNG,32,16,48,1.304060348804467,Hawkish
고부가가치/NNG,113,27,140,2.72886702620194,Hawkish
발언권/NNG,12,5,17,1.5648724185653602,Hawkish
위태/NNG,61,10,71,3.977384063853624,Hawkish
인플레이션/NNG;잡/VV,36,12,48,1.9560905232067003,Hawkish
원달러/NNG;안정/NNG,19,5,24,2.4777146627284874,Hawkish
게시물/NNG,22,9,31,1.5938515374276818,Hawkish
수출/NNG;경기/NNG;불확실성/NNG,19,2,21,6.194286656821219,Hawkish
기둥/NNG,17,5,22,2.216902592967594,Hawkish
기업인/NNG,59,28,87,1.3739207246332776,Hawkish
직원/NNG,648,308,956,1.371803743547556,Hawkish
농협중앙회/NNG,20,7,27,1.8629433554349528,Hawkish
기대/NNG;밀리/VV,17,7,24,1.58350185211971,Hawkish
웃돌/VV,1628,527,2155,2.0142412218725543,Hawkish
bbb+등급/NNG,25,9,34,1.811194928895093,Hawkish
학군/NNG,52,25,77,1.3562227627566457,Hawkish
부근/NNG,129,61,190,1.3788834835719364,Hawkish
소득금액/NNG,24,1,25,15.648724185653604,Hawkish
공직/NNG,36,4,40,5.868271569620101,Hawkish
개막/NNG,55,23,78,1.5592025909618628,Hawkish
자금/NNG;많/VA,12,6,18,1.3040603488044669,Hawkish
소신/NNG,28,8,36,2.282105610407817,Hawkish
실적시즌/NNG,213,60,273,2.3147071191279287,Hawkish
유니버설/NNG,13,4,17,2.119098066807259,Hawkish
다름없/VA,20,7,27,1.8629433554349528,Hawkish
부동산/NNG;위축/NNG,36,4,40,5.868271569620101,Hawkish
일관/NNG,138,62,200,1.4512929688307776,Hawkish
통풍/NNG,24,1,25,15.648724185653604,Hawkish
가격/NNG;급등/NNG,131,43,174,1.9864175080626183,Hawkish
현금배당/NNG,48,11,59,2.8452225792097456,Hawkish
인하/NNG;가능성/NNG;후퇴/NNG,23,3,26,4.998898003750457,Hawkish
수납/NNG,25,3,28,5.433584786685279,Hawkish
국채/NNG;스프레드/NNG;축소/NNG,18,6,24,1.9560905232067003,Hawkish
규모의경제/NNG,39,18,57,1.4127320445381726,Hawkish
건전재정/NNG,57,23,80,1.6159008669968395,Hawkish
항만/NNG,71,15,86,3.0862761588372383,Hawkish
밀리/VV,780,375,1155,1.3562227627566457,Hawkish
전선주/NNG,16,8,24,1.304060348804467,Hawkish
식히/VV,12,5,17,1.5648724185653602,Hawkish
반박/NNG,46,15,61,1.9995592015001824,Hawkish
이뤄지도록/VV,24,7,31,2.2355320265219434,Hawkish
삼정/NNG,57,10,67,3.716571994092731,Hawkish
사나/NNG,35,16,51,1.426316006504886,Hawkish
청취/NNG,118,42,160,1.831894299511037,Hawkish
계약서비스마진/NNG,19,6,25,2.0647622189404062,Hawkish
전세/NNG;수요/NNG;늘/VV,16,3,19,3.477494263478579,Hawkish
예약/NNG,83,26,109,2.0814809413609763,Hawkish
예산편성/NNG,27,13,40,1.3542165160661772,Hawkish
부자/NNG,378,73,451,3.3762658345759484,Hawkish
금리선물/NNG;시장/NNG;금리/NNG;인하/NNG,16,3,19,3.477494263478579,Hawkish
소비/NNG;부진/NNG,109,22,131,3.230513136811066,Hawkish
대통령실/NNG,116,47,163,1.6092659623544487,Hawkish
실적/NNG;방어/NNG,23,1,24,14.996694011251371,Hawkish
국제/NNG;유가/NNG;오르/VV,49,23,72,1.3891077628569324,Hawkish
보급/NNG,61,13,74,3.059526202964326,Hawkish
시민/NNG,155,62,217,1.6300754360055838,Hawkish
전시회/NNG,38,8,46,3.0971433284106094,Hawkish
손꼽히/VV,24,11,35,1.4226112896048728,Hawkish
금융안전망/NNG,27,2,29,8.802407354430152,Hawkish
국무회의/NNG,37,6,43,4.020852742147107,Hawkish
리스크오프/NNG,13,5,18,1.6952784534458072,Hawkish
개방형펀드/NNG,17,8,25,1.3855641206047462,Hawkish
수요자/NNG;높/VA,16,2,18,5.216241395217868,Hawkish
영어/NNG,32,14,46,1.4903546843479625,Hawkish
제조업/NNG;회복/NNG,18,6,24,1.9560905232067003,Hawkish
햇살론/NNG,156,39,195,2.6081206976089337,Hawkish
상업화/NNG,24,10,34,1.5648724185653602,Hawkish
수요/NNG;약세/NNG,14,3,17,3.042807480543756,Hawkish
대목/NNG,113,50,163,1.4735881941490476,Hawkish
판매가격/NNG;확대/NNG,17,2,19,5.542256482418985,Hawkish
소득/NNG;증가/NNG,52,19,71,1.784503635206113,Hawkish
보호제/NNG,20,2,22,6.520301744022335,Hawkish
일학/NNG,29,11,40,1.7189886416058884,Hawkish
부유세/NNG,26,2,28,8.476392267229036,Hawkish
위험/NNG;감소/NNG,19,6,25,2.0647622189404062,Hawkish
다이내믹스/NNG,12,5,17,1.5648724185653602,Hawkish
농기계/NNG,102,1,103,66.50707778902782,Hawkish
내부통제/NNG,325,37,362,5.727292072452051,Hawkish
경제/NNG;견조/NNG,40,16,56,1.6300754360055838,Hawkish
갖추/VV,463,204,667,1.4798527977854612,Hawkish
똑같이/MAG,41,8,49,3.341654643811447,Hawkish
임직원/NNG,249,120,369,1.3529626118846343,Hawkish
스마트/NNG,160,59,219,1.768217422107752,Hawkish
소득/NNG;감소/NNG,37,14,51,1.7232226037773315,Hawkish
이격/NNG,20,1,21,13.04060348804467,Hawkish
양도차익/NNG,34,17,51,1.304060348804467,Hawkish
경영/NNG,1750,826,2576,1.381419861021681,Hawkish
오픈/NNG,396,141,537,1.8312336812998895,Hawkish
선고/NNG,24,12,36,1.3040603488044669,Hawkish
연안/NNG,29,6,35,3.151479176277462,Hawkish
똑같/VA,53,25,78,1.3823039697327348,Hawkish
하락국면/NNG,44,18,62,1.5938515374276818,Hawkish
주거래은행/NNG,58,8,66,4.727218764416193,Hawkish
상속인/NNG,41,3,44,8.911079050163858,Hawkish
매수청구권/NNG,18,5,23,2.3473086278480406,Hawkish
판매/NNG;늘/VV,30,11,41,1.7782641120060911,Hawkish
활력/NNG;높/VV,16,2,18,5.216241395217868,Hawkish
영업점/NNG,327,144,471,1.4806518543717386,Hawkish
환원/NNG,391,170,561,1.499669401125137,Hawkish
고전/NNG,80,35,115,1.4903546843479625,Hawkish
워크아웃/NNG,429,100,529,2.7972094481855816,Hawkish
수출주/NNG,71,29,100,1.5963497373296065,Hawkish
공모주청약/NNG,79,13,92,3.962337213675111,Hawkish
외화예탁금/NNG,16,1,17,10.432482790435737,Hawkish
배출량/NNG,41,9,50,2.970359683387952,Hawkish
기다려/VV,21,9,30,1.5214037402718783,Hawkish
감축목표/NNG,20,3,23,4.346867829348224,Hawkish
최상위/NNG,96,39,135,1.6049973523747283,Hawkish
매입자금/NNG,26,11,37,1.5411622304052792,Hawkish
그린/NNG,40,18,58,1.4489559431160743,Hawkish
기업/NNG;실적/NNG;부진/NNG,19,9,28,1.3765081459602708,Hawkish
싸우/VV,14,3,17,3.042807480543756,Hawkish
전망/NNG;높/VV,39,6,45,4.238196133614518,Hawkish
비금융주력자/NNG,21,1,22,13.692633662446903,Hawkish
프라이빗뱅커/NNG,40,11,51,2.371018816008122,Hawkish
읽힌다/VV,24,9,33,1.738747131739289,Hawkish
돌이켜/VV,20,8,28,1.6300754360055838,Hawkish
각자/NNG,37,17,54,1.4191244972283903,Hawkish
사노피/NNG,18,3,21,3.912181046413401,Hawkish
도쿄/NNG,193,69,262,1.8237945457917548,Hawkish
포천/NNG,24,10,34,1.5648724185653602,Hawkish
소통/NNG,372,162,534,1.497254474553277,Hawkish
지정학/NNG;위험/NNG,477,199,676,1.5629064984415346,Hawkish
강수/NNG,29,8,37,2.363609382208097,Hawkish
운송비/NNG,16,7,23,1.4903546843479625,Hawkish
권하/VV,39,16,55,1.589323550105444,Hawkish
목적지/NNG,29,5,34,3.7817750115329543,Hawkish
기름/NNG,104,49,153,1.383900778323108,Hawkish
불렸/VV,31,14,45,1.4437811004620884,Hawkish
공사장/NNG,16,2,18,5.216241395217868,Hawkish
진위/NNG,17,3,20,3.69483765494599,Hawkish
불변/NNG,43,11,54,2.548845227208731,Hawkish
선물환/NNG,79,39,118,1.320779071225037,Hawkish
베테랑/NNG,13,6,19,1.4127320445381726,Hawkish
지원금/NNG,477,78,555,3.9874152973059664,Hawkish
예상/NNG;견조/NNG,13,5,18,1.6952784534458072,Hawkish
성장/NNG;안정/NNG,31,7,38,2.887562200924177,Hawkish
단지/MAG,875,299,1174,1.9081150588694125,Hawkish
따지/VV,76,38,114,1.304060348804467,Hawkish
편향/NNG,25,11,36,1.481886760005076,Hawkish
대북/NNG,51,19,70,1.7501862576059952,Hawkish
파생상품/NNG,155,61,216,1.6567979841368228,Hawkish
기상청/NNG,13,4,17,2.119098066807259,Hawkish
설명회/NNG,280,79,359,2.3109930231977898,Hawkish
쓴다고/VV,17,3,20,3.69483765494599,Hawkish
거둬/VV,26,4,30,4.238196133614518,Hawkish
근무/NNG,194,64,258,1.9764664661567704,Hawkish
봉쇄/NNG,111,40,151,1.809383733966198,Hawkish
상생/NNG,755,170,925,2.895781068668743,Hawkish
매머드/NNG,15,5,20,1.9560905232067003,Hawkish
자본비율/NNG;하락/NNG,19,7,26,1.7697961876632051,Hawkish
설수/NNG,21,8,29,1.7115792078058631,Hawkish
물색/NNG,23,5,28,2.999338802250274,Hawkish
전세가격/NNG;높/VA,14,3,17,3.042807480543756,Hawkish
신축/NNG,567,205,772,1.8034200433466647,Hawkish
밀접/NNG,128,55,183,1.517452042245198,Hawkish
총선거/NNG,26,3,29,5.65092817815269,Hawkish
개량/NNG,21,3,24,4.564211220815635,Hawkish
전시/NNG,68,34,102,1.304060348804467,Hawkish
재무관/NNG,29,8,37,2.363609382208097,Hawkish
인플레이션/NNG;압력/NNG;완화/NNG,19,8,27,1.548571664205305,Hawkish
사그라지/VV,18,5,23,2.3473086278480406,Hawkish
밑그림/NNG,15,5,20,1.9560905232067003,Hawkish
출고/NNG,31,15,46,1.3475290270979492,Hawkish
외환시장/NNG;원달러/NNG;내리/VV,20,3,23,4.346867829348224,Hawkish
주원/NNG,123,20,143,4.009985572573736,Hawkish
자본력/NNG,61,9,70,4.419315626504027,Hawkish
대거/MAG,364,177,541,1.3408982117650452,Hawkish
주택담보대출/NNG;금리/NNG;하향/NNG,15,3,18,3.260150872011167,Hawkish
주식회사/NNG,31,13,44,1.5548411851130184,Hawkish
비유/NNG,53,15,68,2.303839949554558,Hawkish
공급/NNG;늘/VV,48,18,66,1.738747131739289,Hawkish
꾸준/NNG,288,144,432,1.3040603488044669,Hawkish
건의/NNG,146,44,190,2.1635546696074117,Hawkish
개당/NNG,18,6,24,1.9560905232067003,Hawkish
지속가능경영/NNG,17,8,25,1.3855641206047462,Hawkish
높/VA;인하/NNG,17,7,24,1.58350185211971,Hawkish
총채/NNG,17,8,25,1.3855641206047462,Hawkish
기대/NNG;꺾/VV,21,9,30,1.5214037402718783,Hawkish
경영/NNG;환경/NNG;불확실성/NNG,22,1,23,14.344663836849138,Hawkish
가격/NNG;인상/NNG,100,36,136,1.811194928895093,Hawkish
운영체제/NNG,24,6,30,2.6081206976089337,Hawkish
서든스톱/NNG,17,2,19,5.542256482418985,Hawkish
상환능력/NNG;취약/NNG,15,3,18,3.260150872011167,Hawkish
경제/NNG;호황/NNG,21,10,31,1.3692633662446905,Hawkish
실기/NNG,14,5,19,1.8256844883262535,Hawkish
운반/NNG,18,7,25,1.6766490198914574,Hawkish
리드/NNG,44,13,57,2.206871359515252,Hawkish
마스터/NNG,48,2,50,15.648724185653604,Hawkish
높/VA;고금리/NNG,22,11,33,1.3040603488044669,Hawkish
제각각/NNG,23,4,27,3.749173502812843,Hawkish
한매/NNG,56,5,61,7.302737953305015,Hawkish
수출/NNG;긍정적/VAX,14,6,20,1.521403740271878,Hawkish
한국자금중개/NNG,21,9,30,1.5214037402718783,Hawkish
집값/NNG;불안/NNG,16,2,18,5.216241395217868,Hawkish
순이자마진/NNG;상승/NNG,25,1,26,16.300754360055837,Hawkish
다각화/NNG,176,72,248,1.5938515374276818,Hawkish
저감/NNG,40,9,49,2.8979118862321487,Hawkish
잘못/NNG,26,12,38,1.4127320445381726,Hawkish
가공품/NNG,19,1,20,12.388573313642436,Hawkish
종신보험/NNG,79,26,105,1.981168606837556,Hawkish
부쳐/VV,12,5,17,1.5648724185653602,Hawkish
계약금/NNG,234,91,325,1.6766490198914576,Hawkish
사용자/NNG,143,67,210,1.3916464916346176,Hawkish
분담금/NNG,194,91,285,1.3900423498245418,Hawkish
기울였/VV,29,9,38,2.100986117518308,Hawkish
다가섰/VV,37,17,54,1.4191244972283903,Hawkish
소비자/NNG;물가/NNG;상승/NNG,120,25,145,3.1297448371307204,Hawkish
일선/NNG,41,18,59,1.485179841693976,Hawkish
갱신청구권/NNG,104,20,124,3.3905569068916144,Hawkish
승수/NNG,82,7,89,7.638067757283306,Hawkish
은행주의/NNG,16,3,19,3.477494263478579,Hawkish
감정가격/NNG,20,1,21,13.04060348804467,Hawkish
부동산/NNG,7627,3602,11229,1.380631354848927,Hawkish
기준가격/NNG;내리/VV,18,6,24,1.9560905232067003,Hawkish
웃돈/NNG,322,76,398,2.762548896809464,Hawkish
따른다/VV,16,6,22,1.7387471317392895,Hawkish
일요/NNG,35,6,41,3.803509350679696,Hawkish
퀄컴/NNG,67,26,93,1.680231603267294,Hawkish
부동산/NNG;불황/NNG,12,6,18,1.3040603488044669,Hawkish
지급금/NNG,47,1,48,30.645418196904977,Hawkish
와치/NNG,17,5,22,2.216902592967594,Hawkish
원화/NNG;절하/NNG,21,10,31,1.3692633662446905,Hawkish
재환/NNG,22,11,33,1.3040603488044669,Hawkish
인적공제/NNG,13,4,17,2.119098066807259,Hawkish
물가/NNG;환율/NNG;안정/NNG,23,4,27,3.749173502812843,Hawkish
팁스/NNG,16,4,20,2.608120697608934,Hawkish
밀어붙이/VV,16,2,18,5.216241395217868,Hawkish
즐거움/NNG,21,4,25,3.4231584156117263,Hawkish
유가/NNG;오르/VV,53,25,78,1.3823039697327348,Hawkish
입주민/NNG,125,43,168,1.895436553494865,Hawkish
소유권이전등기/NNG,24,2,26,7.824362092826802,Hawkish
세제/NNG,509,246,755,1.3491193445964913,Hawkish
정해지/VV,140,67,207,1.3624511106912345,Hawkish
신속히/MAG,147,71,218,1.3499779667201173,Hawkish
bw/NNG,41,19,60,1.4070124816048195,Hawkish
예부/NNG,18,1,19,11.736543139240204,Hawkish
환경규제/NNG,21,5,26,2.738526732489381,Hawkish
페달/NNG,12,5,17,1.5648724185653602,Hawkish
호수/NNG,53,16,69,2.1598499527073987,Hawkish
지지력/NNG,38,12,50,2.0647622189404062,Hawkish
부동산정보/NNG,98,47,145,1.3595522785408274,Hawkish
줄인다/VV,16,5,21,2.0864965580871475,Hawkish
에스티/NNG,17,7,24,1.58350185211971,Hawkish
피해/NNG,984,279,1263,2.2996333032680925,Hawkish
방어주/NNG,17,3,20,3.69483765494599,Hawkish
안보리/NNG,42,2,44,13.692633662446903,Hawkish
작물/NNG,41,3,44,8.911079050163858,Hawkish
미일/NNG,164,33,197,3.2403923818777662,Hawkish
나란히/MAG,140,47,187,1.9422175407726103,Hawkish
물가/NNG;상방/NNG;압력/NNG,58,14,72,2.701267865380682,Hawkish
트랙/NNG,44,9,53,3.187703074855364,Hawkish
탐욕/NNG,76,35,111,1.4158369501305643,Hawkish
성명문/NNG,29,7,36,2.701267865380682,Hawkish
계류/NNG,24,7,31,2.2355320265219434,Hawkish
공동출자/NNG,18,2,20,5.868271569620101,Hawkish
원양/NNG,18,1,19,11.736543139240204,Hawkish
재건축조합/NNG,44,5,49,5.737865534739655,Hawkish
원자재/NNG;가격/NNG;인상/NNG,39,11,50,2.3117433456079186,Hawkish
비용률/NNG,27,1,28,17.604814708860303,Hawkish
스승/NNG,16,3,19,3.477494263478579,Hawkish
위탁/NNG,132,60,192,1.4344663836849136,Hawkish
주거비/NNG,266,131,397,1.3239696671068253,Hawkish
뉴타운/NNG,45,17,62,1.7259622263588537,Hawkish
보장성보험/NNG,78,15,93,3.390556906891614,Hawkish
eb/NNG,71,35,106,1.3226897823588166,Hawkish
공주/NNG,26,5,31,3.3905569068916144,Hawkish
고용/NNG;지표/NNG;금리/NNG;인하/NNG,15,5,20,1.9560905232067003,Hawkish
결연/NNG,175,1,176,114.10528052039086,Hawkish
비용/NNG;오르/VV,26,13,39,1.304060348804467,Hawkish
자금/NNG;확보/NNG,74,25,99,1.9300093162306111,Hawkish
빅맥지수/NNG,14,4,18,2.282105610407817,Hawkish
기본계획/NNG,30,10,40,1.9560905232067003,Hawkish
프로그램/NNG;금리/NNG;인하/NNG,22,5,27,2.8689327673698277,Hawkish
실적/NNG;상승/NNG,77,18,95,2.789240190498443,Hawkish
ecb/NNG;금리/NNG;낮/VV,17,3,20,3.69483765494599,Hawkish
수출/NNG;회복/NNG,170,58,228,1.911122924972064,Hawkish
주거환경/NNG,82,22,104,2.430294286408325,Hawkish
조각/NNG,49,5,54,6.389895709141888,Hawkish
실적/NNG;개선/NNG,291,132,423,1.4374301572049235,Hawkish
시장조사기관/NNG,22,11,33,1.3040603488044669,Hawkish
대출/NNG;문턱/NNG;높/VV,52,14,66,2.4218263620654388,Hawkish
공습/NNG,259,98,357,1.7232226037773315,Hawkish
라니냐/NNG,14,6,20,1.521403740271878,Hawkish
다지기/NNG,29,10,39,1.8908875057664771,Hawkish
잇단/VV,47,17,64,1.802671658641469,Hawkish
젊은이/NNG,27,12,39,1.467067892405025,Hawkish
조직/NNG,279,114,393,1.595758058405466,Hawkish
담당/NNG,502,176,678,1.8597678838063705,Hawkish
적립액/NNG,25,8,33,2.03759429500698,Hawkish
국채/NNG;금리/NNG;뛰/VV,16,6,22,1.7387471317392895,Hawkish
역전세난/NNG,17,4,21,2.7711282412094924,Hawkish
시리즈/NNG,191,47,238,2.649739644911204,Hawkish
택했/VV,30,11,41,1.7782641120060911,Hawkish
할인/NNG,535,259,794,1.3468576961590537,Hawkish
가수급/NNG,22,8,30,1.7930829796061425,Hawkish
대기자금/NNG;늘/VV,13,4,17,2.119098066807259,Hawkish
걸렸/VV,90,34,124,1.7259622263588537,Hawkish
비대/VV,455,177,632,1.6761227647063066,Hawkish
목표비중/NNG,20,8,28,1.6300754360055838,Hawkish
교외/NNG,22,2,24,7.172331918424569,Hawkish
경제/NNG;성장률/NNG;오르/VV,20,5,25,2.608120697608934,Hawkish
기일/NNG,30,8,38,2.4451131540083755,Hawkish
기대/NNG;증가/NNG,14,4,18,2.282105610407817,Hawkish
기초지수/NNG,76,18,94,2.7530162919205416,Hawkish
일시불/NNG,22,3,25,4.7815546122830455,Hawkish
강하/VA;상승/NNG,49,23,72,1.3891077628569324,Hawkish
한다는/VV,70,21,91,2.173433914674112,Hawkish
진도/NNG,243,60,303,2.6407222063290456,Hawkish
부사관/NNG,29,4,33,4.727218764416193,Hawkish
생산/NNG;둔화/NNG,22,6,28,2.3907773061415227,Hawkish
감면/NNG,322,121,443,1.735154678987762,Hawkish
가자지구/NNG,59,22,81,1.7486263768059898,Hawkish
분양/NNG,2278,733,3011,2.0263638980740626,Hawkish
투자금융/NNG,58,11,69,3.4379772832117768,Hawkish
금과은/NNG,26,6,32,2.825464089076345,Hawkish
정책위/NNG,13,4,17,2.119098066807259,Hawkish
전직/NNG,27,12,39,1.467067892405025,Hawkish
뚜껑/NNG,14,5,19,1.8256844883262535,Hawkish
드러난/VV,34,11,45,2.0153659936069035,Hawkish
경기/NNG;안/MAG;좋/VA,19,8,27,1.548571664205305,Hawkish
원천/NNG,72,22,94,2.133916934407309,Hawkish
정체국면/NNG,17,8,25,1.3855641206047462,Hawkish
야당/NNG,582,98,680,3.872260831654081,Hawkish
골고루/MAG,28,13,41,1.4043726833278876,Hawkish
국제가격/NNG,19,6,25,2.0647622189404062,Hawkish
천장/NNG,14,7,21,1.3040603488044669,Hawkish
서리/NNG,13,6,19,1.4127320445381726,Hawkish
국고여유자금/NNG,16,1,17,10.432482790435737,Hawkish
부속/NNG,25,8,33,2.03759429500698,Hawkish
경쟁자/NNG,28,14,42,1.3040603488044669,Hawkish
들어갔/VV,110,48,158,1.494235816338452,Hawkish
캐피털/NNG,158,70,228,1.4717252507936127,Hawkish
통화주의/NNG,28,3,31,6.085614961087512,Hawkish
영종/NNG,36,11,47,2.133916934407309,Hawkish
이익/NNG;늘/VV,35,8,43,2.852632013009772,Hawkish
적잖/VA,40,20,60,1.304060348804467,Hawkish
특판상품/NNG,41,16,57,1.6708273219057237,Hawkish
인포테인먼트/NNG,27,2,29,8.802407354430152,Hawkish
퇴직연금/NNG,316,91,407,2.264192693528635,Hawkish
물가/NNG;상승률/NNG;점차/MAG;둔화/NNG,20,1,21,13.04060348804467,Hawkish
금융시장/NNG;변동성/NNG;높/VA,24,4,28,3.912181046413401,Hawkish
수입/NNG;확대/NNG,24,9,33,1.738747131739289,Hawkish
부동산/NNG;pf/NNG;대출/NNG;부실/NNG,47,15,62,2.043027879793665,Hawkish
토요/NNG,21,2,23,6.846316831223453,Hawkish
증원/NNG,55,9,64,3.984628843569205,Hawkish
낙찰가율/NNG,400,50,450,5.2162413952178674,Hawkish
위험자산/NNG;선호/NNG;위축/NNG,17,8,25,1.3855641206047462,Hawkish
발돋움/NNG,15,3,18,3.260150872011167,Hawkish
예비/NNG,288,125,413,1.5022775218227458,Hawkish
전고점/NNG,271,94,365,1.879789119819205,Hawkish
버금가/VV,23,6,29,2.4994490018752287,Hawkish
곳곳/NNG,189,62,251,1.9876403703551957,Hawkish
시급/NNG,198,83,281,1.5554454762848462,Hawkish
쌓였/VV,19,9,28,1.3765081459602708,Hawkish
주택사업/NNG,274,61,335,2.928791275183803,Hawkish
배당기준일/NNG,13,5,18,1.6952784534458072,Hawkish
옥동/NNG,17,4,21,2.7711282412094924,Hawkish
가업상속/NNG,25,8,33,2.03759429500698,Hawkish
트렌드분석/NNG,24,1,25,15.648724185653604,Hawkish
잣대/NNG,41,13,54,2.056402857730121,Hawkish
지준/NNG,95,45,140,1.3765081459602706,Hawkish
동반자/NNG,15,4,19,2.4451131540083755,Hawkish
미뤄졌/VV,36,16,52,1.467067892405025,Hawkish
기업/NNG;대출/NNG;늘/VV,27,4,31,4.401203677215076,Hawkish
소비/NNG;부양/NNG,30,3,33,6.520301744022334,Hawkish
시공사/NNG,437,174,611,1.6375700357113565,Hawkish
전망/NNG;밝/VA;않/VX,24,10,34,1.5648724185653602,Hawkish
주주환원정책/NNG,147,19,166,5.044654507217281,Hawkish
채권/NNG;성공/NNG,17,3,20,3.69483765494599,Hawkish
흑자/NNG;확대/NNG,18,6,24,1.9560905232067003,Hawkish
급등락/NNG,42,20,62,1.3692633662446905,Hawkish
자산효과/NNG,16,7,23,1.4903546843479625,Hawkish
장외/NNG,177,64,241,1.803270951081177,Hawkish
판매/NNG;촉진/NNG,18,1,19,11.736543139240204,Hawkish
기대/NNG;높/VA;않/VX,12,5,17,1.5648724185653602,Hawkish
발발/NNG,61,24,85,1.6572433599390102,Hawkish
성장/NNG;한계/NNG,16,5,21,2.0864965580871475,Hawkish
버틸/VV,36,15,51,1.5648724185653602,Hawkish
충당금/NNG,767,184,951,2.7179736074267016,Hawkish
각자도생/NNG,28,10,38,1.8256844883262535,Hawkish
인플레이션/NNG;기대/NNG;높/VA,14,5,19,1.8256844883262535,Hawkish
남향/NNG,44,10,54,2.8689327673698277,Hawkish
우버/NNG,53,14,67,2.4683999459513126,Hawkish
일시적/VAX;부진/NNG,12,6,18,1.3040603488044669,Hawkish
포워딩/NNG,23,3,26,4.998898003750457,Hawkish
영업이익/NNG;성장/NNG,28,5,33,3.651368976652508,Hawkish
인하/NNG;지연/NNG,15,4,19,2.4451131540083755,Hawkish
구상/NNG,136,54,190,1.6421500688648842,Hawkish
각료/NNG,23,4,27,3.749173502812843,Hawkish
수요/NNG;압력/NNG,18,8,26,1.467067892405025,Hawkish
클리닉/NNG,33,3,36,7.172331918424568,Hawkish
동인/NNG,36,9,45,2.6081206976089337,Hawkish
물가/NNG;상방/NNG;위험/NNG,24,8,32,1.9560905232067003,Hawkish
펼쳐진/VV,14,4,18,2.282105610407817,Hawkish
높/VA;금리/NNG;부담/NNG,30,6,36,3.260150872011167,Hawkish
확전/NNG,365,137,502,1.7371606836263884,Hawkish
두려움/NNG,33,15,48,1.4344663836849136,Hawkish
매물/NNG,1028,453,1481,1.479662294228468,Hawkish
전망/NNG;하락/NNG,33,14,47,1.536928268233836,Hawkish
수로/NNG,13,4,17,2.119098066807259,Hawkish
예상/NNG;더디/VA,28,11,39,1.6597131712056852,Hawkish
리저브/NNG,32,2,34,10.432482790435737,Hawkish
물가/NNG;상승/NNG,264,117,381,1.4712475730101675,Hawkish
보통/NNG,312,148,460,1.3745500973884923,Hawkish
적자/NNG;늘/VV,12,5,17,1.5648724185653602,Hawkish
결실/NNG,20,5,25,2.608120697608934,Hawkish
소비자/NNG;물가/NNG;상승률/NNG;내리/VV,19,4,23,3.0971433284106094,Hawkish
고용/NNG;증가/NNG,52,17,69,1.9944452393480083,Hawkish
성과지표/NNG,18,4,22,2.9341357848100507,Hawkish
불린/VV,20,5,25,2.608120697608934,Hawkish
봉사/NNG,44,13,57,2.206871359515252,Hawkish
제로/NNG,89,31,120,1.87195759747738,Hawkish
이해관계자/NNG,140,8,148,11.410528052039089,Hawkish
비용/NNG;부담/NNG;크/VV,13,5,18,1.6952784534458072,Hawkish
예대/NNG,13,6,19,1.4127320445381726,Hawkish
인허가/NNG,428,189,617,1.476555103937333,Hawkish
저평가/NNG;해소/NNG,33,10,43,2.1516995755273705,Hawkish
대회/NNG,152,41,193,2.41728259778389,Hawkish
고양/NNG,21,10,31,1.3692633662446905,Hawkish
순수수료/NNG,25,1,26,16.300754360055837,Hawkish
전단/NNG,16,3,19,3.477494263478579,Hawkish
신용보증/NNG,150,54,204,1.8111949288950928,Hawkish
품격/NNG,22,4,26,3.5861659592122845,Hawkish
타진/NNG,32,15,47,1.3909977053914315,Hawkish
쏠립니다/VV,19,2,21,6.194286656821219,Hawkish
위대/NNG,15,7,22,1.3972075165762146,Hawkish
식량/NNG,22,8,30,1.7930829796061425,Hawkish
전략산업/NNG,103,21,124,3.198052760163336,Hawkish
거점/NNG,162,23,185,4.592560358833123,Hawkish
중문/NNG,15,2,17,4.890226308016751,Hawkish
탈동조화/NNG,96,23,119,2.7215172496788878,Hawkish
테스트베드/NNG,12,6,18,1.3040603488044669,Hawkish
이포/NNG,14,3,17,3.042807480543756,Hawkish
은행업/NNG,172,62,234,1.8088579031803895,Hawkish
가격/NNG;고공행진/NNG,29,12,41,1.575739588138731,Hawkish
전세수급지수/NNG,30,7,37,2.794415033152429,Hawkish
밀착/NNG,48,11,59,2.8452225792097456,Hawkish
사업영역/NNG,67,18,85,2.4270012047194247,Hawkish
차종/NNG,93,18,111,3.368822567744873,Hawkish
최저임금제/NNG,20,5,25,2.608120697608934,Hawkish
붙였/VV,22,8,30,1.7930829796061425,Hawkish
냉전/NNG,17,1,18,11.08451296483797,Hawkish
공간/NNG,424,160,584,1.7278799621659189,Hawkish
보입니다/VV,195,88,283,1.4448395910049492,Hawkish
차감/NNG,111,52,163,1.39183364151246,Hawkish
깡통/NNG,24,8,32,1.9560905232067003,Hawkish
전망/NNG;영향/NNG;하락/NNG,16,1,17,10.432482790435737,Hawkish
신약/NNG,105,50,155,1.3692633662446902,Hawkish
협회/NNG,341,154,495,1.4437811004620884,Hawkish
대출/NNG;증가/NNG,44,12,56,2.3907773061415227,Hawkish
대결/NNG,26,9,35,1.8836427260508968,Hawkish
통계국/NNG,34,16,50,1.3855641206047462,Hawkish
경제/NNG;양호/NNG,30,9,39,2.1734339146741117,Hawkish
세제개편안/NNG,35,11,46,2.0746414640071067,Hawkish
권익/NNG,22,7,29,2.049237690978448,Hawkish
통화정책/NNG;방향/NNG;불확실성/NNG,24,1,25,15.648724185653604,Hawkish
권력/NNG,13,6,19,1.4127320445381726,Hawkish
자금력/NNG,46,20,66,1.499669401125137,Hawkish
낙수효과/NNG,57,18,75,2.064762218940406,Hawkish
예상/NNG;높/VA,163,45,208,2.3617981872792013,Hawkish
빚어지/VV,21,6,27,2.2821056104078177,Hawkish
수장/NNG,60,25,85,1.5648724185653602,Hawkish
낸다/VV,35,14,49,1.6300754360055838,Hawkish
감가상각/NNG,15,4,19,2.4451131540083755,Hawkish
개입/NNG,1183,474,1657,1.6273242538351105,Hawkish
야외/NNG,28,6,34,3.042807480543756,Hawkish
회견/NNG,19,8,27,1.548571664205305,Hawkish
pf/NNG;위험/NNG,18,7,25,1.6766490198914574,Hawkish
건드리/VV,16,4,20,2.608120697608934,Hawkish
인버스etf/NNG,23,10,33,1.499669401125137,Hawkish
분쟁/NNG,937,421,1358,1.451193048491432,Hawkish
살림/NNG,78,18,96,2.825464089076345,Hawkish
노동통계국/NNG,58,18,76,2.100986117518308,Hawkish
보조/NNG,126,53,179,1.550109471220404,Hawkish
주채/NNG,27,4,31,4.401203677215076,Hawkish
도시형생활주택/NNG,57,10,67,3.716571994092731,Hawkish
받아들여졌/VV,13,5,18,1.6952784534458072,Hawkish
기대/NNG;줄/VV,24,10,34,1.5648724185653602,Hawkish
앤드/NNG,36,16,52,1.467067892405025,Hawkish
동종/NNG,21,10,31,1.3692633662446905,Hawkish
중처/NNG,29,11,40,1.7189886416058884,Hawkish
총동원/NNG,25,2,27,8.150377180027919,Hawkish
백지/NNG,13,5,18,1.6952784534458072,Hawkish
소비/NNG;여력/NNG;약화/NNG,13,4,17,2.119098066807259,Hawkish
실은/MAG,14,6,20,1.521403740271878,Hawkish
클러스터/NNG,81,29,110,1.8211877285027904,Hawkish
회의실/NNG,35,10,45,2.282105610407817,Hawkish
물가/NNG;금리/NNG;인하/NNG,21,4,25,3.4231584156117263,Hawkish
위기관리/NNG,45,11,56,2.6673961680091374,Hawkish
부동산/NNG;악화/NNG,20,2,22,6.520301744022335,Hawkish
파괴/NNG,37,6,43,4.020852742147107,Hawkish
길이/NNG,12,6,18,1.3040603488044669,Hawkish
금리/NNG;인하/NNG;예상/NNG;늦/VA,43,11,54,2.548845227208731,Hawkish
유통/NNG,784,389,1173,1.3141173694893344,Hawkish
원은/NNG,21,9,30,1.5214037402718783,Hawkish
중형주/NNG,42,15,57,1.8256844883262535,Hawkish
벌어들이/VV,18,9,27,1.3040603488044669,Hawkish
인플레이션/NNG;오르/VV,26,8,34,2.119098066807259,Hawkish
이은/VV,112,47,159,1.5537740326180882,Hawkish
투자자산/NNG,111,32,143,2.261729667457748,Hawkish
벤처캐피털/NNG,44,11,55,2.6081206976089337,Hawkish
운영비/NNG,19,7,26,1.7697961876632051,Hawkish
권역/NNG,251,120,371,1.363829781458005,Hawkish
신제품/NNG,175,32,207,3.5657900162622145,Hawkish
업인/NNG,31,1,32,20.21293540646924,Hawkish
적수/NNG,34,15,49,1.4779350619783955,Hawkish
상대/NNG,407,116,523,2.287726560187147,Hawkish
제일/MAG,181,85,266,1.3884407243153445,Hawkish
소감/NNG,25,4,29,4.075188590013959,Hawkish
다중채무/NNG,54,9,63,3.9121810464134006,Hawkish
끝낸/VV,12,6,18,1.3040603488044669,Hawkish
무수익여신/NNG,62,8,70,5.05323385161731,Hawkish
치사/NNG,14,5,19,1.8256844883262535,Hawkish
일가/NNG,43,14,57,2.002664107092574,Hawkish
찰자/NNG,25,6,31,2.71679239334264,Hawkish
개미/NNG,353,169,522,1.361932849491056,Hawkish
공고문/NNG,22,2,24,7.172331918424569,Hawkish
보정/NNG,22,9,31,1.5938515374276818,Hawkish
연료/NNG,113,51,164,1.4446943079892625,Hawkish
합친/VV,45,21,66,1.3972075165762148,Hawkish
수요/NNG;증가/NNG,208,86,294,1.5770032125077276,Hawkish
호의/NNG,16,4,20,2.608120697608934,Hawkish
수익성/NNG;낮/VA,29,13,42,1.454528850589598,Hawkish
노트/NNG,45,22,67,1.333698084004569,Hawkish
지급액/NNG,33,13,46,1.6551535196364389,Hawkish
매출/NNG;성장/NNG,116,36,152,2.100986117518308,Hawkish
죄송/NNG,12,5,17,1.5648724185653602,Hawkish
용적률인센티브/NNG,19,6,25,2.0647622189404062,Hawkish
매출/NNG;증가/NNG,151,45,196,2.1879234741052724,Hawkish
건축/NNG,260,107,367,1.5843723863979506,Hawkish
난이도/NNG,16,6,22,1.7387471317392895,Hawkish
중국a주/NNG,16,5,21,2.0864965580871475,Hawkish
녹록/NNG;않/VX,111,46,157,1.573377159970607,Hawkish
가성비/NNG,93,24,117,2.526616925808655,Hawkish
메타버스/NNG,15,2,17,4.890226308016751,Hawkish
투자심리/NNG;호조/NNG,15,2,17,4.890226308016751,Hawkish
추정손실/NNG,98,19,117,3.3631030048115207,Hawkish
타사/NNG,43,11,54,2.548845227208731,Hawkish
중견/NNG,751,319,1070,1.5350302851914652,Hawkish
저가형/NNG,18,4,22,2.9341357848100507,Hawkish
숙제/NNG,64,25,89,1.6691972464697178,Hawkish
페이지/NNG,130,58,188,1.461446942625696,Hawkish
유통구조/NNG,38,13,51,1.9059343559449904,Hawkish
자금/NNG;조달/NNG;부담/NNG;완화/NNG,17,2,19,5.542256482418985,Hawkish
집약/NNG,20,6,26,2.173433914674112,Hawkish
콜옵션/NNG,148,68,216,1.4191244972283903,Hawkish
줄다리기/NNG,18,9,27,1.3040603488044669,Hawkish
부추기/VV,217,100,317,1.4149054784528463,Hawkish
일반공모/NNG,27,7,34,2.514973529837186,Hawkish
뼈아프/VA,14,5,19,1.8256844883262535,Hawkish
사철/NNG,15,7,22,1.3972075165762146,Hawkish
합당/NNG,22,8,30,1.7930829796061425,Hawkish
잇따르/VV,437,202,639,1.4105801297711684,Hawkish
민원/NNG,745,81,826,5.997067653452642,Hawkish
실적발표/NNG,799,146,945,3.5683021188177024,Hawkish
기술개발/NNG,88,29,117,1.9785743223240189,Hawkish
적립식/NNG,114,37,151,2.008957834644719,Hawkish
가이던스/NNG,194,92,286,1.374933193848188,Hawkish
중개/NNG,228,74,302,2.008957834644719,Hawkish
강수량/NNG,72,12,84,3.912181046413401,Hawkish
경영/NNG;부담/NNG,31,2,33,10.10646770323462,Hawkish
소프트/NNG,36,4,40,5.868271569620101,Hawkish
독서실/NNG,25,5,30,3.260150872011168,Hawkish
차선/NNG,38,5,43,4.955429325456975,Hawkish
ecb/NNG;금리/NNG;인상/NNG,20,7,27,1.8629433554349528,Hawkish
리바운드/NNG,43,1,44,28.03729749929604,Hawkish
성과급/NNG,60,19,79,2.0590426560070534,Hawkish
경기/NNG;전망/NNG;지수/NNG;상승/NNG,18,1,19,11.736543139240204,Hawkish
기업지배구조/NNG,25,10,35,1.6300754360055838,Hawkish
치르/VV,46,22,68,1.36333581920467,Hawkish
대외변수/NNG,68,26,94,1.7053096868981492,Hawkish
벌어진/VV,81,40,121,1.3203611031645228,Hawkish
신작/NNG,20,3,23,4.346867829348224,Hawkish
수수료이익/NNG,102,9,111,7.389675309891979,Hawkish
경제/NNG;시스템/NNG;위험/NNG,26,2,28,8.476392267229036,Hawkish
사태/NNG,1058,512,1570,1.3473592275733657,Hawkish
단골/NNG,23,4,27,3.749173502812843,Hawkish
반독점/NNG,20,2,22,6.520301744022335,Hawkish
수치인/NNG,29,6,35,3.151479176277462,Hawkish
퇴색/NNG,19,6,25,2.0647622189404062,Hawkish
바라보/VV,129,58,187,1.4502050430670368,Hawkish
블루칩/NNG,90,43,133,1.3647143185163029,Hawkish
전망/NNG;늦/VV,20,4,24,3.260150872011168,Hawkish
업로드/NNG,15,4,19,2.4451131540083755,Hawkish
스튜디오/NNG,44,16,60,1.7930829796061425,Hawkish
전량/NNG,42,21,63,1.304060348804467,Hawkish
비상/NNG,402,136,538,1.9273244861007195,Hawkish
기후/NNG,300,72,372,2.7167923933426392,Hawkish
가뜩이나/MAG,66,27,93,1.5938515374276816,Hawkish
국산/NNG,52,25,77,1.3562227627566457,Hawkish
기준가격/NNG;오르/VV,14,7,21,1.3040603488044669,Hawkish
roa/NNG,127,52,179,1.592458310559301,Hawkish
일임/NNG,19,7,26,1.7697961876632051,Hawkish
공세/NNG,99,37,136,1.7446212774546248,Hawkish
가근/NNG,18,1,19,11.736543139240204,Hawkish
각지/NNG,13,5,18,1.6952784534458072,Hawkish
멤버십/NNG,62,24,86,1.6844112838724363,Hawkish
연착륙/NNG,478,224,702,1.3913858185904804,Hawkish
지수/NNG;급락/NNG,18,9,27,1.3040603488044669,Hawkish
무효화/NNG,21,1,22,13.692633662446903,Hawkish
유급/NNG,23,11,34,1.36333581920467,Hawkish
특단/NNG,35,16,51,1.426316006504886,Hawkish
오피니언/NNG,15,7,22,1.3972075165762146,Hawkish
생산원가/NNG,15,2,17,4.890226308016751,Hawkish
금리/NNG;약세/NNG,14,4,18,2.282105610407817,Hawkish
환투기/NNG,31,14,45,1.4437811004620884,Hawkish
주범/NNG,34,12,46,1.847418827472995,Hawkish
공급/NNG;압력/NNG,23,2,25,7.498347005625686,Hawkish
주택담보대출/NNG;금리/NNG;인하/NNG,18,1,19,11.736543139240204,Hawkish
다우존스산업평균지수/NNG,1045,511,1556,1.3334080865955655,Hawkish
유례없이/MAG,25,10,35,1.6300754360055838,Hawkish
투자/NNG;위험/NNG,59,23,82,1.6725991430318163,Hawkish
신청인/NNG,36,6,42,3.912181046413401,Hawkish
긴장/NNG;완화/NNG,44,9,53,3.187703074855364,Hawkish
글로벌/NNG;지정학/NNG;위험/NNG,17,4,21,2.7711282412094924,Hawkish
황금기/NNG,25,1,26,16.300754360055837,Hawkish
존경/NNG,19,9,28,1.3765081459602708,Hawkish
소수점/NNG,17,5,22,2.216902592967594,Hawkish
후드/NNG,26,3,29,5.65092817815269,Hawkish
순이익/NNG,2363,635,2998,2.426373704114138,Hawkish
트위터/NNG,81,15,96,3.5209629417720607,Hawkish
세부/NNG,346,168,514,1.3428716687093618,Hawkish
퇴직급여/NNG,23,3,26,4.998898003750457,Hawkish
저울질/NNG,27,9,36,1.9560905232067003,Hawkish
이전지출/NNG,18,2,20,5.868271569620101,Hawkish
컨센서스/NNG;상회/NNG,27,13,40,1.3542165160661772,Hawkish
녹지/NNG,30,5,35,3.912181046413401,Hawkish
아실/NNG,50,23,73,1.4174569008744209,Hawkish
결렬/NNG,40,20,60,1.304060348804467,Hawkish
할지/VV,24,8,32,1.9560905232067003,Hawkish
레이팅/NNG,18,9,27,1.3040603488044669,Hawkish
바라봐야/VV,15,6,21,1.6300754360055836,Hawkish
전망/NNG;웃돌/VV,177,39,216,2.959213868440905,Hawkish
표정/NNG,19,7,26,1.7697961876632051,Hawkish
자율/NNG,466,83,549,3.660795918933022,Hawkish
예상시기/NNG,29,7,36,2.701267865380682,Hawkish
화상회의/NNG,25,3,28,5.433584786685279,Hawkish
구청/NNG,40,18,58,1.4489559431160743,Hawkish
디아/NNG,16,2,18,5.216241395217868,Hawkish
건과/NNG,13,4,17,2.119098066807259,Hawkish
리딩/NNG,63,11,74,3.734354635212792,Hawkish
지정학/NNG;위험/NNG;확산/NNG,26,3,29,5.65092817815269,Hawkish
총영사/NNG,25,1,26,16.300754360055837,Hawkish
불완전판매/NNG,131,16,147,5.338497052918287,Hawkish
실적배당형/NNG,24,5,29,3.1297448371307204,Hawkish
신탁보수/NNG,38,5,43,4.955429325456975,Hawkish
물가/NNG;떨어/VV,26,11,37,1.5411622304052792,Hawkish
보릿고개/NNG,25,5,30,3.260150872011168,Hawkish
외화부채/NNG,19,4,23,3.0971433284106094,Hawkish
열린다/VV,85,25,110,2.216902592967594,Hawkish
부동산/NNG;하락/NNG,13,5,18,1.6952784534458072,Hawkish
신용카드사/NNG,45,16,61,1.833834865506282,Hawkish
물가/NNG;잡/VV;않/VX,32,7,39,2.9807093686959245,Hawkish
스타트/NNG,15,7,22,1.3972075165762146,Hawkish
권리관계/NNG,25,6,31,2.71679239334264,Hawkish
판가름/NNG,20,5,25,2.608120697608934,Hawkish
기본소득/NNG,19,3,22,4.1295244378808125,Hawkish
형평/NNG,54,10,64,3.5209629417720607,Hawkish
주효/NNG,74,30,104,1.6083410968588423,Hawkish
보유금액/NNG,20,2,22,6.520301744022335,Hawkish
법원/NNG,209,81,290,1.682398845062553,Hawkish
선발/NNG,65,19,84,2.230629544007641,Hawkish
세부업종/NNG,28,2,30,9.128422441631267,Hawkish
수제/NNG,23,3,26,4.998898003750457,Hawkish
수성/NNG,36,16,52,1.467067892405025,Hawkish
분할/NNG,169,52,221,2.119098066807259,Hawkish
지낸/VV,36,17,53,1.3807697810870827,Hawkish
경기/NNG;부진/NNG;완화/NNG,95,2,97,30.97143328410609,Hawkish
유권자/NNG,53,18,71,1.9198666246287983,Hawkish
단장/NNG,84,15,99,3.651368976652508,Hawkish
장마/NNG,29,8,37,2.363609382208097,Hawkish
감소/NNG,8427,4157,12584,1.3217845272281987,Hawkish
주력상품/NNG,32,7,39,2.9807093686959245,Hawkish
상춘/NNG,15,4,19,2.4451131540083755,Hawkish
통상/MAG,58,26,84,1.454528850589598,Hawkish
디폴트옵션/NNG,74,11,85,4.386384809615025,Hawkish
금리/NNG;스프레드/NNG;부담/NNG,31,2,33,10.10646770323462,Hawkish
유로존/NNG;금리/NNG;인하/NNG,19,7,26,1.7697961876632051,Hawkish
출근/NNG,59,10,69,3.8469780289731776,Hawkish
드림/NNG,36,12,48,1.9560905232067003,Hawkish
안개/NNG,18,5,23,2.3473086278480406,Hawkish
이자/NNG;부담/NNG;낮/VV,23,4,27,3.749173502812843,Hawkish
고령자/NNG,137,34,171,2.627298055679588,Hawkish
로보어드바이저/NNG,29,8,37,2.363609382208097,Hawkish
애저/NNG,16,3,19,3.477494263478579,Hawkish
지표/NNG;완화/NNG,14,7,21,1.3040603488044669,Hawkish
기대/VV,21,9,30,1.5214037402718783,Hawkish
구내식당/NNG,23,1,24,14.996694011251371,Hawkish
동일인/NNG,38,2,40,12.388573313642436,Hawkish
시니어/NNG,102,31,133,2.145389606097672,Hawkish
통화정책방향결정회의/NNG,68,18,86,2.4632251032973267,Hawkish
스팩/NNG,111,8,119,9.04691866983099,Hawkish
가격/NNG;내리/VV,67,28,95,1.560215060176773,Hawkish
기업/NNG;구조/NNG;개선/NNG,39,7,46,3.632739543098158,Hawkish
재택근무/NNG,27,8,35,2.200601838607538,Hawkish
가리기/NNG,91,23,114,2.5797715595914457,Hawkish
수익성/NNG;높/VA,56,21,77,1.7387471317392893,Hawkish
경영/NNG;환경/NNG;악화/NNG,27,8,35,2.200601838607538,Hawkish
가점/NNG,53,14,67,2.4683999459513126,Hawkish
기습/NNG,28,5,33,3.651368976652508,Hawkish
중소기업/NNG;대출/NNG;증가/NNG,22,6,28,2.3907773061415227,Hawkish
농민/NNG,26,11,37,1.5411622304052792,Hawkish
분양/NNG;위험/NNG,19,3,22,4.1295244378808125,Hawkish
명확/NNG,233,112,345,1.356455630676075,Hawkish
로펌/NNG,18,8,26,1.467067892405025,Hawkish
질의응답/NNG,21,9,30,1.5214037402718783,Hawkish
달러인덱스/NNG;하락/NNG,14,5,19,1.8256844883262535,Hawkish
인상/NNG;없/VA,15,7,22,1.3972075165762146,Hawkish
패밀리/NNG,54,20,74,1.7604814708860304,Hawkish
대열/NNG,26,12,38,1.4127320445381726,Hawkish
공정거래/NNG,25,4,29,4.075188590013959,Hawkish
개선/NNG;성공/NNG,20,8,28,1.6300754360055838,Hawkish
점쳐진다/VV,37,18,55,1.3402842473823688,Hawkish
다분/NNG,13,4,17,2.119098066807259,Hawkish
통화정책/NNG;불확실성/NNG;해소/NNG,17,2,19,5.542256482418985,Hawkish
무인기/NNG,36,16,52,1.467067892405025,Hawkish
고객수/NNG,59,22,81,1.7486263768059898,Hawkish
한파/NNG,54,22,76,1.600437700805482,Hawkish
채비/NNG,18,9,27,1.3040603488044669,Hawkish
분양가상한제/NNG,110,27,137,2.6564192290461364,Hawkish
매도전략/NNG,400,37,437,7.0489748584025245,Hawkish
뱅커/NNG,149,28,177,3.4697319994976,Hawkish
fed/NNG;금리/NNG;오르/VV,21,6,27,2.2821056104078177,Hawkish
내몰릴/VV,16,3,19,3.477494263478579,Hawkish
dps/NNG,106,9,115,7.679466498515194,Hawkish
사모펀드/NNG,336,115,451,1.9050620747752212,Hawkish
단시일/NNG,25,9,34,1.811194928895093,Hawkish
전략물자/NNG,19,3,22,4.1295244378808125,Hawkish
익경비/NNG,35,7,42,3.260150872011168,Hawkish
완고/NNG,14,4,18,2.282105610407817,Hawkish
금리/NNG;인하/NNG;늦/VV,128,33,161,2.52908673707533,Hawkish
신용등급/NNG;상승/NNG,12,6,18,1.3040603488044669,Hawkish
무이자/NNG,189,61,250,2.020224638721674,Hawkish
쇄신/NNG,49,5,54,6.389895709141888,Hawkish
우려/NNG;줄/VV,20,10,30,1.304060348804467,Hawkish
비즈니스/NNG,213,99,312,1.402852799471472,Hawkish
투자자문/NNG,49,14,63,2.282105610407817,Hawkish
치였/VV,75,37,112,1.3216827859504734,Hawkish
전망/NNG;높/VV;잡/VV,13,4,17,2.119098066807259,Hawkish
긍정적/VAX;영향/NNG;줄/VV,14,5,19,1.8256844883262535,Hawkish
경진/NNG,28,3,31,6.085614961087512,Hawkish
지배구조/NNG,164,69,233,1.5497528782893666,Hawkish
손익/NNG,336,89,425,2.461597062911803,Hawkish
매출/NNG;회복/NNG,17,5,22,2.216902592967594,Hawkish
금리/NNG;하락/NNG;제한적/VAX,13,4,17,2.119098066807259,Hawkish
금융투자/NNG,328,95,423,2.2512199705677114,Hawkish
비농업/NNG;고용자수/NNG;증가/NNG,14,6,20,1.521403740271878,Hawkish
캠프/NNG,37,16,53,1.507819778305165,Hawkish
리프트/NNG,14,5,19,1.8256844883262535,Hawkish
비용/NNG;확대/NNG,16,7,23,1.4903546843479625,Hawkish
충당금적립액/NNG,34,3,37,7.38967530989198,Hawkish
금리/NNG;인하/NNG;불투명/NNG,65,18,83,2.3545534075636207,Hawkish
에너지기업/NNG,26,12,38,1.4127320445381726,Hawkish
실적/NNG;넘/VV,14,3,17,3.042807480543756,Hawkish
매체/NNG,102,47,149,1.4150442082771877,Hawkish
선복/NNG,19,2,21,6.194286656821219,Hawkish
특별배당/NNG,15,4,19,2.4451131540083755,Hawkish
누락/NNG,81,22,103,2.400656551208223,Hawkish
대출/NNG;금리/NNG;낮/VA,41,15,56,1.7822158100327714,Hawkish
유보/NNG,93,42,135,1.4437811004620884,Hawkish
숏포지션/NNG,14,5,19,1.8256844883262535,Hawkish
경제/NNG;강하/VA;성장/NNG,14,5,19,1.8256844883262535,Hawkish
국토연구원/NNG,71,3,74,15.431380794186191,Hawkish
되살릴/VV,12,5,17,1.5648724185653602,Hawkish
경매시장/NNG,187,26,213,4.6896016389699104,Hawkish
지환/NNG,46,9,55,3.332598669166971,Hawkish
직주근접/NNG,50,21,71,1.552452796195794,Hawkish
주임/NNG,21,9,30,1.5214037402718783,Hawkish
실태/NNG,197,62,259,2.0717732960845163,Hawkish
지구단위계획/NNG,29,2,31,9.454437528832386,Hawkish
매출/NNG;줄/VV,67,24,91,1.8202509035395689,Hawkish
부동산업/NNG,138,28,166,3.2135772881252933,Hawkish
전망/NNG;낙관/NNG,13,6,19,1.4127320445381726,Hawkish
탄소중립/NNG,51,14,65,2.3752527781795645,Hawkish
현금성자산/NNG,107,44,151,1.5856188332054313,Hawkish
대출/NNG;위험/NNG,15,6,21,1.6300754360055836,Hawkish
인명/NNG,28,3,31,6.085614961087512,Hawkish
모처럼/MAG,61,27,88,1.4731052088346757,Hawkish
etn/NNG,374,86,460,2.8355730840283178,Hawkish
조기경보/NNG,22,8,30,1.7930829796061425,Hawkish
브랜드/NNG,818,370,1188,1.4415153585433162,Hawkish
위험액/NNG,78,29,107,1.753736331150835,Hawkish
정규직/NNG,27,11,38,1.600437700805482,Hawkish
사업주체/NNG,24,3,27,5.2162413952178674,Hawkish
시장안정화조치/NNG,129,36,165,2.33644145827467,Hawkish
화물/NNG,44,12,56,2.3907773061415227,Hawkish
일축/NNG,72,29,101,1.6188335364469246,Hawkish
가계/NNG;대출/NNG;감소/NNG,57,15,72,2.477714662728487,Hawkish
서빙/NNG,19,3,22,4.1295244378808125,Hawkish
준법감시/NNG,25,10,35,1.6300754360055838,Hawkish
유료/NNG,37,15,52,1.6083410968588423,Hawkish
보상금/NNG,17,5,22,2.216902592967594,Hawkish
뒤이/VV,31,9,40,2.2458817118299157,Hawkish
대국민/NNG,16,5,21,2.0864965580871475,Hawkish
체질/NNG,125,56,181,1.4554244964335568,Hawkish
워크아웃/NNG;기업/NNG;재무구조/NNG;개선/NNG,20,7,27,1.8629433554349528,Hawkish
재정/NNG;지출/NNG;늘/VV,16,4,20,2.608120697608934,Hawkish
비행/NNG,12,6,18,1.3040603488044669,Hawkish
과열/NNG;완화/NNG,16,1,17,10.432482790435737,Hawkish
주식거래대금/NNG,20,7,27,1.8629433554349528,Hawkish
신흥시장/NNG,200,86,286,1.5163492427958918,Hawkish
신용등급/NNG;안정/NNG,29,11,40,1.7189886416058884,Hawkish
맥북/NNG,20,1,21,13.04060348804467,Hawkish
우라늄/NNG,23,5,28,2.999338802250274,Hawkish
모간/NNG,56,24,80,1.521403740271878,Hawkish
기준치/NNG,90,37,127,1.5860193431405682,Hawkish
은행채/NNG;금리/NNG;상승/NNG,17,6,23,1.847418827472995,Hawkish
병무청/NNG,17,1,18,11.08451296483797,Hawkish
사업자보증/NNG,30,2,32,9.780452616033502,Hawkish
건설/NNG;경기/NNG;회복/NNG,35,9,44,2.53567290045313,Hawkish
오일허브/NNG,14,7,21,1.3040603488044669,Hawkish
정부안/NNG,15,7,22,1.3972075165762146,Hawkish
난다/VV,48,24,72,1.3040603488044669,Hawkish
무장/NNG,38,16,54,1.548571664205305,Hawkish
식비/NNG,33,15,48,1.4344663836849136,Hawkish
공급/NNG;개선/NNG,25,4,29,4.075188590013959,Hawkish
보행/NNG,13,4,17,2.119098066807259,Hawkish
기업/NNG;이익/NNG;증가/NNG,24,8,32,1.9560905232067003,Hawkish
방카슈랑스/NNG,64,5,69,8.34598623234859,Hawkish
프로그램/NNG,1687,614,2301,1.7914900720139542,Hawkish
은행/NNG;주택담보대출/NNG;증가/NNG,16,6,22,1.7387471317392895,Hawkish
전망/NNG;고금리/NNG,15,3,18,3.260150872011167,Hawkish
연산/NNG,37,14,51,1.7232226037773315,Hawkish
언저리/NNG,13,5,18,1.6952784534458072,Hawkish
대출자산/NNG;늘/VV,16,5,21,2.0864965580871475,Hawkish
다방/NNG,42,10,52,2.738526732489381,Hawkish
순이자이익/NNG,64,7,71,5.961418737391849,Hawkish
정쟁/NNG,14,6,20,1.521403740271878,Hawkish
면역/NNG,16,7,23,1.4903546843479625,Hawkish
엑스/NNG,82,24,106,2.2277697625409645,Hawkish
보임/NNG,40,10,50,2.608120697608934,Hawkish
보류지/NNG,31,2,33,10.10646770323462,Hawkish
일회성/NNG,56,15,71,2.434245984435005,Hawkish
나체/NNG,19,1,20,12.388573313642436,Hawkish
채널/NNG,648,284,932,1.4877308204670678,Hawkish
평했/VV,21,7,28,1.9560905232067007,Hawkish
가격/NNG;충격/NNG,15,3,18,3.260150872011167,Hawkish
전재/NNG,33,8,41,2.689624469409213,Hawkish
노무/NNG,30,15,45,1.3040603488044669,Hawkish
경제/NNG;불확실성/NNG,40,20,60,1.304060348804467,Hawkish
물가/NNG;불확실성/NNG,36,11,47,2.133916934407309,Hawkish
돋보인다/VV,30,15,45,1.3040603488044669,Hawkish
추출/NNG,21,9,30,1.5214037402718783,Hawkish
리빙/NNG,53,9,62,3.839733249257597,Hawkish
취득/NNG,207,73,280,1.84890748083921,Hawkish
듀얼/NNG,41,9,50,2.970359683387952,Hawkish
일제/NNG,26,11,37,1.5411622304052792,Hawkish
부합/NNG,724,186,910,2.538009926167834,Hawkish
수탁고/NNG,91,8,99,7.416843233825407,Hawkish
실적/NNG,6776,2883,9659,1.532485765435149,Hawkish
잠잠/NNG,53,25,78,1.3823039697327348,Hawkish
수두룩/NNG,16,7,23,1.4903546843479625,Hawkish
재의/NNG,33,8,41,2.689624469409213,Hawkish
매수우위/NNG,165,71,236,1.515281391216458,Hawkish
경제사/NNG,19,2,21,6.194286656821219,Hawkish
순이익/NNG;줄/VV,61,18,79,2.2096578132520137,Hawkish
흑자/NNG,948,473,1421,1.3068173474277325,Hawkish
손바뀜/NNG,98,28,126,2.282105610407817,Hawkish
시나리오분석/NNG,23,3,26,4.998898003750457,Hawkish
명함/NNG,28,3,31,6.085614961087512,Hawkish
제조원가/NNG,21,6,27,2.2821056104078177,Hawkish
전망/NNG;불안/NNG,27,1,28,17.604814708860303,Hawkish
대주/NNG,47,19,66,1.612916747205525,Hawkish
출자자/NNG,49,4,53,7.987369636427361,Hawkish
결의안/NNG,16,2,18,5.216241395217868,Hawkish
하루치/NNG,105,26,131,2.633198781239789,Hawkish
부채/NNG;거품/NNG,19,1,20,12.388573313642436,Hawkish
밸런스/NNG,24,1,25,15.648724185653604,Hawkish
자동차보험료/NNG,24,12,36,1.3040603488044669,Hawkish
종합자산관리계좌/NNG,32,16,48,1.304060348804467,Hawkish
둔화/NNG;우려/NNG,20,8,28,1.6300754360055838,Hawkish
취약점/NNG,20,9,29,1.4489559431160743,Hawkish
충돌/NNG,282,128,410,1.436503977979921,Hawkish
레버리지etf/NNG,36,15,51,1.5648724185653602,Hawkish
밀착형/NNG,31,2,33,10.10646770323462,Hawkish
정통/NNG,20,7,27,1.8629433554349528,Hawkish
통지서/NNG,15,2,17,4.890226308016751,Hawkish
환경변화/NNG,93,35,128,1.7325373205545065,Hawkish
돌아간/VV,15,2,17,4.890226308016751,Hawkish
수익/NNG;늘/VV,31,14,45,1.4437811004620884,Hawkish
사관/NNG,25,11,36,1.481886760005076,Hawkish
비트/NNG,270,113,383,1.5579482043239206,Hawkish
모릅니다/VV,14,4,18,2.282105610407817,Hawkish
매기/VV,42,12,54,2.2821056104078177,Hawkish
버그/NNG,17,5,22,2.216902592967594,Hawkish
저율/NNG,20,7,27,1.8629433554349528,Hawkish
갇힌/VV,17,7,24,1.58350185211971,Hawkish
맞닿/VV,21,8,29,1.7115792078058631,Hawkish
전약후강/NNG,41,19,60,1.4070124816048195,Hawkish
운전/NNG,27,13,40,1.3542165160661772,Hawkish
지청/NNG,29,1,30,18.908875057664773,Hawkish
회복/NNG;내수/NNG;부진/NNG,17,1,18,11.08451296483797,Hawkish
농산물/NNG;가격/NNG;안정/NNG,36,13,49,1.8056220214215697,Hawkish
케어/NNG,62,28,90,1.4437811004620884,Hawkish
순이익/NNG;흑자전환/NNG,17,6,23,1.847418827472995,Hawkish
부실/NNG;위험/NNG,78,27,105,1.8836427260508968,Hawkish
농산물/NNG;가격/NNG;불안/NNG,15,5,20,1.9560905232067003,Hawkish
원내/NNG,16,6,22,1.7387471317392895,Hawkish
퇴석/NNG,14,5,19,1.8256844883262535,Hawkish
중위험/NNG,19,4,23,3.0971433284106094,Hawkish
소비시장/NNG,18,6,24,1.9560905232067003,Hawkish
춘계/NNG,58,10,68,3.7817750115329543,Hawkish
지수/NNG;상승/NNG;견인/NNG,40,16,56,1.6300754360055838,Hawkish
작가/NNG,59,12,71,3.205815024144315,Hawkish
삼중고/NNG,24,8,32,1.9560905232067003,Hawkish
처리/NNG,769,290,1059,1.729004152121785,Hawkish
두루/MAG,60,16,76,2.4451131540083755,Hawkish
코리아펀드/NNG,36,2,38,11.736543139240204,Hawkish
얼라이언스/NNG,56,12,68,3.042807480543756,Hawkish
물가/NNG;상승/NNG;억제/NNG,18,5,23,2.3473086278480406,Hawkish
계층/NNG,128,63,191,1.324759719420411,Hawkish
산인/NNG,15,5,20,1.9560905232067003,Hawkish
선구/NNG,43,6,49,4.67288291654934,Hawkish
초순/NNG,21,7,28,1.9560905232067007,Hawkish
수출/NNG;부정적/VAX,18,7,25,1.6766490198914574,Hawkish
발주/NNG,92,36,128,1.6662993345834856,Hawkish
차등/NNG,116,54,170,1.400657411678872,Hawkish
배상금/NNG,121,18,139,4.383091727926125,Hawkish
내려놓/VV,13,6,19,1.4127320445381726,Hawkish
농안법/NNG,71,1,72,46.29414238255858,Hawkish
수익성/NNG;높/VV,34,12,46,1.847418827472995,Hawkish
스틱/NNG,35,11,46,2.0746414640071067,Hawkish
켤까/VV,48,1,49,31.29744837130721,Hawkish
주고받/VV,26,12,38,1.4127320445381726,Hawkish
고금리/NNG;부담/NNG,56,22,78,1.6597131712056852,Hawkish
환산/NNG,208,88,296,1.5411622304052792,Hawkish
빠듯/NNG,30,8,38,2.4451131540083755,Hawkish
인플레이션/NNG;지표/NNG;둔화/NNG,20,4,24,3.260150872011168,Hawkish
안진/NNG,21,8,29,1.7115792078058631,Hawkish
중소협력사/NNG,22,5,27,2.8689327673698277,Hawkish
이익/NNG;확대/NNG,14,4,18,2.282105610407817,Hawkish
부정적/VAX;영향/NNG;줄/VV,14,7,21,1.3040603488044669,Hawkish
벤처/NNG,630,69,699,5.953318983672567,Hawkish
수요자/NNG;선호/NNG;높/VA,14,3,17,3.042807480543756,Hawkish
유림/NNG,22,2,24,7.172331918424569,Hawkish
상속/NNG,71,34,105,1.361592423016429,Hawkish
직무/NNG,37,14,51,1.7232226037773315,Hawkish
건설/NNG;투자/NNG;둔화/NNG,39,1,40,25.429176801687102,Hawkish
해상/NNG,109,19,128,3.7405941584128137,Hawkish
가격/NNG;방어/NNG,14,3,17,3.042807480543756,Hawkish
운암/NNG,21,5,26,2.738526732489381,Hawkish
재고/NNG;감소/NNG,15,7,22,1.3972075165762146,Hawkish
부담금/NNG,75,31,106,1.5774923574247584,Hawkish
상여금/NNG,32,13,45,1.6049973523747287,Hawkish
전고점/NNG;넘/VV,19,3,22,4.1295244378808125,Hawkish
원가/NNG;개선/NNG,14,3,17,3.042807480543756,Hawkish
실망/NNG,300,137,437,1.42780330161073,Hawkish
정대/NNG,13,6,19,1.4127320445381726,Hawkish
대출/NNG;금리/NNG;낮/VV,29,12,41,1.575739588138731,Hawkish
실물/NNG;경제/NNG;성장/NNG,14,3,17,3.042807480543756,Hawkish
수율/NNG,16,8,24,1.304060348804467,Hawkish
기대/NNG;약하/VA,20,8,28,1.6300754360055838,Hawkish
보험회사/NNG,79,22,101,2.34138108080802,Hawkish
금리/NNG;인하/NNG;지연/NNG,580,241,821,1.5692012495987362,Hawkish
아파트매매가격지수/NNG,34,11,45,2.0153659936069035,Hawkish
경기/NNG;둔화/NNG;금리/NNG;인상/NNG,15,2,17,4.890226308016751,Hawkish
제일/NNG,37,8,45,3.01563955661033,Hawkish
안전진단/NNG,74,18,92,2.6805684947647377,Hawkish
만기평가일/NNG,28,1,29,18.256844883262534,Hawkish
가스/NNG,286,122,408,1.528529753106875,Hawkish
반감기/NNG,351,89,440,2.5714897889346515,Hawkish
물류/NNG,206,86,292,1.561839720079769,Hawkish
비경쟁인수/NNG,14,5,19,1.8256844883262535,Hawkish
사격/NNG,27,10,37,1.7604814708860304,Hawkish
불명예/NNG,20,3,23,4.346867829348224,Hawkish
재투자/NNG,180,86,266,1.3647143185163029,Hawkish
경락/NNG,48,2,50,15.648724185653604,Hawkish
대출/NNG;넘/VV,13,4,17,2.119098066807259,Hawkish
특판/NNG,276,68,344,2.6464754137502418,Hawkish
조준기/NNG,26,7,33,2.4218263620654388,Hawkish
전전/NNG,33,13,46,1.6551535196364389,Hawkish
환손실/NNG,27,4,31,4.401203677215076,Hawkish
영세자영업자/NNG,66,15,81,2.8689327673698277,Hawkish
체감/NNG,444,193,637,1.5000072405937392,Hawkish
경공/NNG,95,14,109,4.4244904691580125,Hawkish
분양권/NNG,69,25,94,1.7996032813501643,Hawkish
공급/NNG;급감/NNG,20,10,30,1.304060348804467,Hawkish
탈바꿈/NNG,37,13,50,1.85577818868328,Hawkish
마법/NNG,19,2,21,6.194286656821219,Hawkish
물밑/NNG,16,4,20,2.608120697608934,Hawkish
자본잠식/NNG;해소/NNG,28,2,30,9.128422441631267,Hawkish
공급/NNG;어렵/VA,14,3,17,3.042807480543756,Hawkish
후년/NNG,17,5,22,2.216902592967594,Hawkish
서금/NNG,21,7,28,1.9560905232067007,Hawkish
시급히/MAG,25,3,28,5.433584786685279,Hawkish
설명서/NNG,22,8,30,1.7930829796061425,Hawkish
일주일/NNG,14,3,17,3.042807480543756,Hawkish
건설/NNG,3238,1307,4545,1.6153586111051508,Hawkish
귀농/NNG,83,12,95,4.509875372948781,Hawkish
시험대/NNG,15,4,19,2.4451131540083755,Hawkish
오물/NNG,20,4,24,3.260150872011168,Hawkish
공급/NNG;확대/NNG,112,40,152,1.8256844883262535,Hawkish
적시/NNG,74,28,102,1.7232226037773315,Hawkish
던질/VV,14,5,19,1.8256844883262535,Hawkish
계약금융/NNG,33,10,43,2.1516995755273705,Hawkish
홀로/MAG,255,127,382,1.3091944446659018,Hawkish
중후반대/NNG,38,9,47,2.7530162919205416,Hawkish
선뜻/MAG,44,19,63,1.5099646144051724,Hawkish
대리점/NNG,79,33,112,1.56092072053868,Hawkish
선인/NNG,24,10,34,1.5648724185653602,Hawkish
실성/NNG,18,4,22,2.9341357848100507,Hawkish
증권가/NNG,596,274,870,1.4182846129333253,Hawkish
우려/NNG;완화/NNG,55,25,80,1.4344663836849136,Hawkish
정해져/VV,28,13,41,1.4043726833278876,Hawkish
로켓/NNG,43,17,60,1.6492527940762378,Hawkish
치부/NNG,17,3,20,3.69483765494599,Hawkish
농산물/NNG,902,283,1185,2.078202181310299,Hawkish
금리/NNG;가격/NNG;반대/NNG,64,28,92,1.4903546843479625,Hawkish
위촉/NNG,45,4,49,7.335339462025128,Hawkish
변동성/NNG;줄/VV,20,9,29,1.4489559431160743,Hawkish
구상권/NNG,13,4,17,2.119098066807259,Hawkish
전력반도체/NNG,21,3,24,4.564211220815635,Hawkish
성장주/NNG,195,81,276,1.5697022717090807,Hawkish
훌쩍/MAG,178,66,244,1.7585056218726902,Hawkish
과소평가/NNG,24,8,32,1.9560905232067003,Hawkish
약정/NNG,330,141,471,1.526028067749908,Hawkish
경제/NNG;냉각/NNG,14,6,20,1.521403740271878,Hawkish
승리/NNG,119,58,177,1.3377860474804446,Hawkish
고공행진/NNG,298,149,447,1.3040603488044669,Hawkish
가방/NNG,28,14,42,1.3040603488044669,Hawkish
조정안/NNG,71,2,73,23.14707119127929,Hawkish
봐서/VV,32,9,41,2.318329508985719,Hawkish
수동/NNG,15,6,21,1.6300754360055836,Hawkish
질적/VAX;성장/NNG,26,5,31,3.3905569068916144,Hawkish
폐장/NNG,16,5,21,2.0864965580871475,Hawkish
인플레이션/NNG;우려/NNG,83,33,116,1.639954681072284,Hawkish
패시브/NNG,40,4,44,6.520301744022335,Hawkish
물가/NNG;급등/NNG,39,18,57,1.4127320445381726,Hawkish
개편안/NNG,19,3,22,4.1295244378808125,Hawkish
소비자/NNG;물가/NNG;완화/NNG,16,4,20,2.608120697608934,Hawkish
녹취/NNG,19,2,21,6.194286656821219,Hawkish
사회관계망/NNG,24,12,36,1.3040603488044669,Hawkish
여력/NNG;크/VV,15,4,19,2.4451131540083755,Hawkish
순이익/NNG;증가/NNG,67,22,89,1.985728258406802,Hawkish
조세특례제한법/NNG,28,10,38,1.8256844883262535,Hawkish
전매/NNG,62,22,84,1.8375395824062943,Hawkish
신탁업/NNG,19,4,23,3.0971433284106094,Hawkish
출원/NNG,17,2,19,5.542256482418985,Hawkish
임하/VV,18,5,23,2.3473086278480406,Hawkish
전임/NNG,28,8,36,2.282105610407817,Hawkish
투입/NNG,604,259,863,1.5205645765982587,Hawkish
저변/NNG,56,28,84,1.3040603488044669,Hawkish
대지진/NNG,17,6,23,1.847418827472995,Hawkish
통화정책/NNG;불안/NNG,27,11,38,1.600437700805482,Hawkish
수요/NNG;늘/VV,173,72,245,1.5666836134942554,Hawkish
시립/NNG,22,11,33,1.3040603488044669,Hawkish
지대/NNG,62,22,84,1.8375395824062943,Hawkish
원화/NNG;하락/NNG,92,42,134,1.4282565725001306,Hawkish
제어/NNG,94,40,134,1.5322709098452487,Hawkish
사용량/NNG,43,19,62,1.4756472368050548,Hawkish
시중/NNG;금리/NNG;높/VA,19,1,20,12.388573313642436,Hawkish
기금운용계획/NNG,31,11,42,1.8375395824062943,Hawkish
체력/NNG,136,66,202,1.343577329071269,Hawkish
외화대출/NNG,47,16,63,1.915338637306561,Hawkish
경제/NNG;활성화/NNG,99,44,143,1.467067892405025,Hawkish
석수/NNG,12,5,17,1.5648724185653602,Hawkish
번역/NNG,26,13,39,1.304060348804467,Hawkish
전하/VV,1751,836,2587,1.365675640404678,Hawkish
투자/NNG;비중/NNG;늘/VV,15,7,22,1.3972075165762146,Hawkish
하자/NNG,40,9,49,2.8979118862321487,Hawkish
기업가/NNG,38,13,51,1.9059343559449904,Hawkish
에이치/NNG,19,9,28,1.3765081459602708,Hawkish
퀴즈/NNG,30,14,44,1.3972075165762146,Hawkish
놓였/VV,32,14,46,1.4903546843479625,Hawkish
강력히/MAG,28,8,36,2.282105610407817,Hawkish
요주/NNG,61,18,79,2.2096578132520137,Hawkish
피해/NNG;막/VV,17,6,23,1.847418827472995,Hawkish
기댈/VV,14,7,21,1.3040603488044669,Hawkish
좀비/NNG,18,3,21,3.912181046413401,Hawkish
바로미터/NNG,26,8,34,2.119098066807259,Hawkish
대출/NNG;조건/NNG;완화/NNG,29,2,31,9.454437528832386,Hawkish
금리/NNG;인하/NNG;기대/NNG;살/VV,76,17,93,2.914958426739397,Hawkish
버전/NNG,42,14,56,1.9560905232067007,Hawkish
경기/NNG;선행/NNG;지수/NNG;상승/NNG,13,4,17,2.119098066807259,Hawkish
내셔널/VAX,29,4,33,4.727218764416193,Hawkish
고질/NNG,24,11,35,1.4226112896048728,Hawkish
원점/NNG,46,9,55,3.332598669166971,Hawkish
녹록/NNG,149,58,207,1.6750430342402207,Hawkish
영입/NNG,58,22,80,1.7189886416058884,Hawkish
본격/NNG,1412,694,2106,1.326608942731922,Hawkish
걸리/VV,425,190,615,1.458488548004996,Hawkish
금고/NNG,169,77,246,1.4310792139477593,Hawkish
산책/NNG,17,3,20,3.69483765494599,Hawkish
영업권/NNG,27,3,30,5.868271569620101,Hawkish
단기/NNG;변동성/NNG;확대/NNG,19,5,24,2.4777146627284874,Hawkish
직급/NNG,137,12,149,7.444011157758832,Hawkish
판매/NNG;감소/NNG,51,13,64,2.557964530347224,Hawkish
스태그플레이션/NNG;경기/NNG;침체/NNG,28,2,30,9.128422441631267,Hawkish
gdp/NNG;성장률/NNG;전망/NNG;상향/NNG,22,4,26,3.5861659592122845,Hawkish
대접/NNG,19,5,24,2.4777146627284874,Hawkish
벤처펀드/NNG,99,3,102,21.516995755273705,Hawkish
이뤄낸/VV,17,4,21,2.7711282412094924,Hawkish
합의점/NNG,59,8,67,4.8087225362164725,Hawkish
신국/NNG,12,6,18,1.3040603488044669,Hawkish
복사/NNG,58,22,80,1.7189886416058884,Hawkish
순이익/NNG;급감/NNG,19,7,26,1.7697961876632051,Hawkish
신용/NNG;대출/NNG;증가/NNG,25,12,37,1.3583961966713198,Hawkish
지불/NNG,90,44,134,1.333698084004569,Hawkish
전인/NNG,33,9,42,2.3907773061415227,Hawkish
민간/NNG,3056,1423,4479,1.40028405690318,Hawkish
배출/NNG,53,25,78,1.3823039697327348,Hawkish
답한/VV,70,24,94,1.901754675339848,Hawkish
야대/NNG,114,16,130,4.645714992615914,Hawkish
덕분/NNG,323,123,446,1.7122418400969222,Hawkish
긴축/NNG;확장/NNG,26,1,27,16.952784534458072,Hawkish
실물/NNG;경기/NNG;부진/NNG,22,9,31,1.5938515374276818,Hawkish
불러일으켰/VV,25,11,36,1.481886760005076,Hawkish
물가/NNG;상승률/NNG;오르/VV,14,3,17,3.042807480543756,Hawkish
동발/NNG,60,29,89,1.3490279470391038,Hawkish
심각/NNG;우려/NNG,56,4,60,9.128422441631267,Hawkish
습관/NNG,33,16,49,1.3448122347046063,Hawkish
느긋/NNG,14,3,17,3.042807480543756,Hawkish
행서/NNG,15,6,21,1.6300754360055836,Hawkish
연령층/NNG,15,5,20,1.9560905232067003,Hawkish
투자/NNG;둔화/NNG,22,7,29,2.049237690978448,Hawkish
직방/NNG,121,28,149,2.8177018250953663,Hawkish
분양가/NNG,1716,455,2171,2.459085229174138,Hawkish
세액공제/NNG,185,47,232,2.566501750306664,Hawkish
고속도/NNG,31,15,46,1.3475290270979492,Hawkish
중장년층/NNG,38,17,55,1.4574792133696983,Hawkish
만능/NNG,35,7,42,3.260150872011168,Hawkish
불황형/NNG,50,18,68,1.811194928895093,Hawkish
맞춤/VV,27,4,31,4.401203677215076,Hawkish
점유/NNG,24,10,34,1.5648724185653602,Hawkish
비스/NNG,14,4,18,2.282105610407817,Hawkish
약정금리/NNG,21,4,25,3.4231584156117263,Hawkish
임재/NNG,27,5,32,3.5209629417720607,Hawkish
커버드콜/NNG,161,63,224,1.6662993345834856,Hawkish
기촉법/NNG,14,6,20,1.521403740271878,Hawkish
상당수/NNG,185,92,277,1.3111476333088392,Hawkish
일회성요인/NNG,56,8,64,4.5642112208156345,Hawkish
뒷걸음질/NNG,51,17,68,1.9560905232067003,Hawkish
미납/NNG,26,4,30,4.238196133614518,Hawkish
갑작/NNG,25,5,30,3.260150872011168,Hawkish
온탕/NNG,15,3,18,3.260150872011167,Hawkish
여권/NNG,24,8,32,1.9560905232067003,Hawkish
이행/NNG,496,160,656,2.021293540646924,Hawkish
고심/NNG,99,48,147,1.3448122347046063,Hawkish
위법/NNG,32,6,38,3.477494263478579,Hawkish
종결/NNG,45,21,66,1.3972075165762148,Hawkish
사업지/NNG,139,32,171,2.8322560700597017,Hawkish
기상악화/NNG,24,8,32,1.9560905232067003,Hawkish
신화/NNG,28,11,39,1.6597131712056852,Hawkish
불어난/VV,99,47,146,1.3734252609749174,Hawkish
금리/NNG;낮/VV;않/VX,18,2,20,5.868271569620101,Hawkish
경기/NNG;불안/NNG,30,7,37,2.794415033152429,Hawkish
골드/NNG,121,30,151,2.629855036755675,Hawkish
인텔리전스/NNG,95,46,141,1.3465840558306996,Hawkish
순이익/NNG;오르/VV,23,5,28,2.999338802250274,Hawkish
조정세/NNG,31,8,39,2.526616925808655,Hawkish
영향권/NNG,27,7,34,2.514973529837186,Hawkish
재고율/NNG,34,6,40,3.69483765494599,Hawkish
눈덩이/NNG,37,15,52,1.6083410968588423,Hawkish
재원/NNG,837,305,1142,1.7893418228677689,Hawkish
이의신청/NNG,19,3,22,4.1295244378808125,Hawkish
쓴다/VV,19,7,26,1.7697961876632051,Hawkish
경제/NNG;부담/NNG,43,15,58,1.869153166619736,Hawkish
연령대/NNG,78,28,106,1.816369771549079,Hawkish
보이스피싱/NNG,169,28,197,3.935467838356338,Hawkish
대형사/NNG,92,24,116,2.4994490018752287,Hawkish
날개/NNG,24,9,33,1.738747131739289,Hawkish
유래/NNG,13,5,18,1.6952784534458072,Hawkish
금리/NNG;낮/VV;어렵/VA,12,5,17,1.5648724185653602,Hawkish
존중/NNG,33,13,46,1.6551535196364389,Hawkish
소모품/NNG,13,6,19,1.4127320445381726,Hawkish
일드스프레드/NNG,28,13,41,1.4043726833278876,Hawkish
캠코/NNG,188,76,264,1.612916747205525,Hawkish
협의체/NNG,152,19,171,5.216241395217868,Hawkish
월드/NNG,104,33,137,2.0548829738737053,Hawkish
상담/NNG,404,124,528,2.124356374665341,Hawkish
장식/NNG,15,7,22,1.3972075165762146,Hawkish
새해/NNG,25,11,36,1.481886760005076,Hawkish
검사/NNG,197,61,258,2.1057367927416397,Hawkish
초청/NNG,57,22,79,1.6893509064057866,Hawkish
글로벌/NNG;위험/NNG;회피/NNG,26,6,32,2.825464089076345,Hawkish
지급여력비율/NNG,81,16,97,3.3009027579113077,Hawkish
추론/NNG,27,12,39,1.467067892405025,Hawkish
인플레이션/NNG;우려/NNG;금리/NNG;인하/NNG,14,5,19,1.8256844883262535,Hawkish
닷컴/NNG,145,70,215,1.350633932690341,Hawkish
반격/NNG,50,24,74,1.3583961966713198,Hawkish
예찬/NNG,17,5,22,2.216902592967594,Hawkish
법칙/NNG,46,23,69,1.304060348804467,Hawkish
뜯어보/VV,15,4,19,2.4451131540083755,Hawkish
재부/NNG,15,4,19,2.4451131540083755,Hawkish
경제/NNG;체질/NNG;개선/NNG,21,7,28,1.9560905232067007,Hawkish
기초자산/NNG,306,99,405,2.0153659936069035,Hawkish
민간/NNG;소비/NNG;부진/NNG,34,13,47,1.7053096868981492,Hawkish
유가증권관련이익/NNG,36,1,37,23.473086278480405,Hawkish
국회의원/NNG,140,61,201,1.4964626953493885,Hawkish
보유계약/NNG,15,3,18,3.260150872011167,Hawkish
캐시/NNG,48,24,72,1.3040603488044669,Hawkish
종사/NNG,38,9,47,2.7530162919205416,Hawkish
보험료율/NNG,35,2,37,11.410528052039089,Hawkish
금리/NNG;최대/NNG,26,13,39,1.304060348804467,Hawkish
실용/NNG,27,7,34,2.514973529837186,Hawkish
공급/NNG;차질/NNG,35,14,49,1.6300754360055838,Hawkish
부가가치/NNG,63,25,88,1.6431160394936284,Hawkish
맞췄/VV,36,14,50,1.6766490198914574,Hawkish
지키/VV,136,64,200,1.3855641206047462,Hawkish
지역민/NNG,18,8,26,1.467067892405025,Hawkish
벤처/NNG;투자/NNG;활성화/NNG,28,2,30,9.128422441631267,Hawkish
낮/VA;증가/NNG,28,5,33,3.651368976652508,Hawkish
내면/NNG,22,6,28,2.3907773061415227,Hawkish
위기극복/NNG,61,29,90,1.3715117461564224,Hawkish
귀촌/NNG,50,1,51,32.601508720111674,Hawkish
마중물/NNG,61,24,85,1.6572433599390102,Hawkish
변동성/NNG;낮/VV,14,7,21,1.3040603488044669,Hawkish
책임지/VV,72,21,93,2.2355320265219434,Hawkish
충당금/NNG;부담/NNG,33,8,41,2.689624469409213,Hawkish
국채선물/NNG,2081,922,3003,1.4716646344154534,Hawkish
포석/NNG,17,6,23,1.847418827472995,Hawkish
목표비율/NNG,17,5,22,2.216902592967594,Hawkish
내수/NNG;둔화/NNG,44,11,55,2.6081206976089337,Hawkish
코픽스/NNG;내리/VV,16,8,24,1.304060348804467,Hawkish
앞바다/NNG,17,4,21,2.7711282412094924,Hawkish
기준임금/NNG,18,1,19,11.736543139240204,Hawkish
과세/NNG,420,128,548,2.139474009757329,Hawkish
이피/NNG,13,6,19,1.4127320445381726,Hawkish
크로스오버/NNG,23,1,24,14.996694011251371,Hawkish
안목/NNG,25,7,32,2.328679194293691,Hawkish
유학/NNG,16,6,22,1.7387471317392895,Hawkish
가의/NNG,25,8,33,2.03759429500698,Hawkish
플레이션/NNG,39,12,51,2.119098066807259,Hawkish
운임/NNG,109,33,142,2.153675424540711,Hawkish
부풀/VV,28,6,34,3.042807480543756,Hawkish
자평/NNG,39,16,55,1.589323550105444,Hawkish
소프트랜딩/NNG,53,2,55,17.27879962165919,Hawkish
세울/VV,25,8,33,2.03759429500698,Hawkish
제안/NNG,666,249,915,1.7439843218951303,Hawkish
맞먹/VV,25,3,28,5.433584786685279,Hawkish
샘플/NNG,22,5,27,2.8689327673698277,Hawkish
가격/NNG;하락/NNG,268,111,379,1.5742710517098972,Hawkish
환율보고서/NNG,16,5,21,2.0864965580871475,Hawkish
취급비중/NNG,13,6,19,1.4127320445381726,Hawkish
bb등급/NNG,30,7,37,2.794415033152429,Hawkish
선행/NNG;지표/NNG;부진/NNG,25,2,27,8.150377180027919,Hawkish
토담/NNG,16,2,18,5.216241395217868,Hawkish
인정받/VV,191,82,273,1.5187532111076412,Hawkish
동등/NNG,23,8,31,1.8745867514064212,Hawkish
영업/NNG,1549,657,2206,1.5372827095115065,Hawkish
관여/NNG,17,8,25,1.3855641206047462,Hawkish
약국/NNG,42,13,55,2.106559024991832,Hawkish
바이/NNG,61,26,87,1.529763101482163,Hawkish
글로벌/NNG;경기/NNG;상승/NNG,17,5,22,2.216902592967594,Hawkish
급난/NNG,23,4,27,3.749173502812843,Hawkish
부동산정책/NNG,88,26,114,2.206871359515252,Hawkish
귀띔/NNG,26,10,36,1.6952784534458072,Hawkish
가용자본/NNG,38,9,47,2.7530162919205416,Hawkish
노도/NNG,32,15,47,1.3909977053914315,Hawkish
보험금/NNG,123,24,147,3.341654643811447,Hawkish
장병/NNG,46,16,62,1.8745867514064212,Hawkish
강일/NNG,13,5,18,1.6952784534458072,Hawkish
포지셔닝/NNG,14,3,17,3.042807480543756,Hawkish
개동/NNG,30,5,35,3.912181046413401,Hawkish
경기/NNG;좋/VA,52,13,65,2.608120697608934,Hawkish
졸라매/VV,18,4,22,2.9341357848100507,Hawkish
fed/NNG;금리/NNG;낮/VV,27,7,34,2.514973529837186,Hawkish
들어온/VV,46,22,68,1.36333581920467,Hawkish
기대/NNG;인플레이션/NNG;상승/NNG,78,13,91,3.912181046413401,Hawkish
유포/NNG,24,6,30,2.6081206976089337,Hawkish
환입/NNG,68,9,77,4.926450206594653,Hawkish
스톱/NNG,137,13,150,6.871394914854307,Hawkish
건설/NNG;경기/NNG;침체/NNG,44,14,58,2.049237690978448,Hawkish
횡재/NNG,82,2,84,26.733237150491576,Hawkish
경기/NNG;회복/NNG;기대/NNG;높/VA,15,3,18,3.260150872011167,Hawkish
지표/NNG;둔화/NNG;금리/NNG;인하/NNG,22,6,28,2.3907773061415227,Hawkish
적자전환/NNG,77,35,112,1.434466383684914,Hawkish
찾아온/VV,18,7,25,1.6766490198914574,Hawkish
스크린/NNG,36,6,42,3.912181046413401,Hawkish
신계약/NNG,88,10,98,5.737865534739655,Hawkish
gdp/NNG;성장/NNG,55,17,72,2.109509387771932,Hawkish
업무지구/NNG,76,19,95,2.608120697608934,Hawkish
매출/NNG;둔화/NNG,28,3,31,6.085614961087512,Hawkish
벌이/VV,90,42,132,1.3972075165762148,Hawkish
모은다/VV,49,16,65,1.99684240910684,Hawkish
대내외/NNG;경제/NNG;여건/NNG;불확실성/NNG,17,2,19,5.542256482418985,Hawkish
결제수요/NNG,19,4,23,3.0971433284106094,Hawkish
의견서/NNG,16,1,17,10.432482790435737,Hawkish
보존/NNG,26,11,37,1.5411622304052792,Hawkish
매우/MAG;부담/NNG,32,4,36,5.216241395217868,Hawkish
그림자/NNG,41,19,60,1.4070124816048195,Hawkish
동한/VV,18,4,22,2.9341357848100507,Hawkish
고용/NNG;호조/NNG,17,6,23,1.847418827472995,Hawkish
달러엔/NNG,306,130,436,1.534778718208334,Hawkish
불만/NNG,174,48,222,2.363609382208097,Hawkish
롤러코스터/NNG,38,14,52,1.7697961876632051,Hawkish
삼각/NNG,24,4,28,3.912181046413401,Hawkish
소득세법/NNG,35,9,44,2.53567290045313,Hawkish
약점/NNG,29,14,43,1.350633932690341,Hawkish
연대채무/NNG,56,1,57,36.51368976652508,Hawkish
마음대로/MAG,14,3,17,3.042807480543756,Hawkish
공모주/NNG,258,98,356,1.7165692346507782,Hawkish
배당정책/NNG,24,8,32,1.9560905232067003,Hawkish
논설위원/NNG,43,17,60,1.6492527940762378,Hawkish
강달러/NNG,357,141,498,1.6508849096567189,Hawkish
만드/VV,223,103,326,1.411676979531049,Hawkish
다자개발은행/NNG,18,6,24,1.9560905232067003,Hawkish
신원/NNG,29,6,35,3.151479176277462,Hawkish
산업부/NNG,70,25,95,1.8256844883262535,Hawkish
속속/MAG,137,49,186,1.8230231406756323,Hawkish
손해액/NNG,30,4,34,4.890226308016751,Hawkish
이어서/VV,47,23,70,1.3324094868219554,Hawkish
조국/NNG,30,8,38,2.4451131540083755,Hawkish
교류/NNG,50,25,75,1.3040603488044669,Hawkish
파일럿/NNG,16,7,23,1.4903546843479625,Hawkish
랩어카운트/NNG,23,2,25,7.498347005625686,Hawkish
참전/NNG,25,7,32,2.328679194293691,Hawkish
경영권/NNG,100,47,147,1.387298243409007,Hawkish
연매/NNG,12,6,18,1.3040603488044669,Hawkish
상승률/NNG;추세/NNG,12,5,17,1.5648724185653602,Hawkish
참여연대/NNG,16,1,17,10.432482790435737,Hawkish
석자/NNG,20,9,29,1.4489559431160743,Hawkish
성장/NNG;둔화/NNG,93,44,137,1.3781546868047208,Hawkish
최대이익/NNG,37,4,41,6.03127911322066,Hawkish
내전/NNG,21,4,25,3.4231584156117263,Hawkish
런칭/NNG,36,17,53,1.3807697810870827,Hawkish
가격/NNG;오르/VV,259,120,379,1.4072984597514873,Hawkish
종부/NNG,14,3,17,3.042807480543756,Hawkish
공급/NNG;증가/NNG,45,13,58,2.2570275267769624,Hawkish
주주가치/NNG,91,14,105,4.238196133614518,Hawkish
대여금/NNG,92,14,106,4.284769717500391,Hawkish
입지/NNG,502,157,659,2.084835334712874,Hawkish
무상/NNG,126,57,183,1.4413298592049373,Hawkish
온다/VV,20,9,29,1.4489559431160743,Hawkish
마트/NNG,124,22,146,3.6750791648125887,Hawkish
공동개발/NNG,22,11,33,1.3040603488044669,Hawkish
일으킨/VV,17,8,25,1.3855641206047462,Hawkish
팔린/VV,37,15,52,1.6083410968588423,Hawkish
영업이익/NNG;급감/NNG,27,8,35,2.200601838607538,Hawkish
수산물/NNG,39,11,50,2.3117433456079186,Hawkish
자산계정/NNG,18,5,23,2.3473086278480406,Hawkish
농업/NNG,154,36,190,2.789240190498443,Hawkish
시장조사업체/NNG,47,18,65,1.702523233161387,Hawkish
금융소비자보호/NNG,34,13,47,1.7053096868981492,Hawkish
들였/VV,16,4,20,2.608120697608934,Hawkish
입구/NNG,15,7,22,1.3972075165762146,Hawkish
띈다/VV,77,34,111,1.4766565714403523,Hawkish
자금/NNG;선순환/NNG,19,3,22,4.1295244378808125,Hawkish
불공정거래행위/NNG,22,3,25,4.7815546122830455,Hawkish
전담/NNG,175,30,205,3.803509350679695,Hawkish
전략/NNG,3520,1453,4973,1.5795913378498705,Hawkish
한국인/NNG,61,23,84,1.7292974190667934,Hawkish
가격결정/NNG,17,3,20,3.69483765494599,Hawkish
영업이익/NNG;흑자전환/NNG,29,9,38,2.100986117518308,Hawkish
손실/NNG,1882,790,2672,1.5533174534493714,Hawkish
주거지역/NNG,19,7,26,1.7697961876632051,Hawkish
사역/NNG,15,2,17,4.890226308016751,Hawkish
전신/NNG,14,5,19,1.8256844883262535,Hawkish
연체율/NNG;넘/VV,34,12,46,1.847418827472995,Hawkish
대출/NNG;문턱/NNG;높/VA,43,13,56,2.1567151922535417,Hawkish
관리감독/NNG,39,16,55,1.589323550105444,Hawkish
가라앉/VV,76,33,109,1.5016452501384772,Hawkish
맞서/VV,50,21,71,1.552452796195794,Hawkish
통화/NNG;약세/NNG,71,33,104,1.402852799471472,Hawkish
정보통신기술/NNG,12,6,18,1.3040603488044669,Hawkish
감돌/VV,20,5,25,2.608120697608934,Hawkish
물가/NNG;불안/NNG,89,31,120,1.87195759747738,Hawkish
불확실성/NNG;낮/VV,15,3,18,3.260150872011167,Hawkish
깜깜/MAG,17,4,21,2.7711282412094924,Hawkish
인플레이션/NNG;낮/VA,30,8,38,2.4451131540083755,Hawkish
알렸/VV,31,11,42,1.8375395824062943,Hawkish
클린/NNG,16,6,22,1.7387471317392895,Hawkish
마진/NNG;개선/NNG,23,5,28,2.999338802250274,Hawkish
절감/NNG,492,244,736,1.3147493680569626,Hawkish
원동력/NNG,60,13,73,3.009370035702616,Hawkish
질주/NNG,36,9,45,2.6081206976089337,Hawkish
수진/NNG,23,1,24,14.996694011251371,Hawkish
머니/NNG,351,92,443,2.4876368610346087,Hawkish
저항선/NNG,113,37,150,1.9913353974987127,Hawkish
복구/NNG,61,17,78,2.3396376846197797,Hawkish
근원/NNG;물가/NNG;상승/NNG,32,11,43,1.896815052806497,Hawkish
집값/NNG;하락/NNG,57,25,82,1.4866287976370922,Hawkish
물가/NNG;상승/NNG;완화/NNG,15,4,19,2.4451131540083755,Hawkish
장려금/NNG,17,5,22,2.216902592967594,Hawkish
응찰/NNG,209,67,276,2.0339448723890565,Hawkish
가계/NNG;부채비율/NNG;넘/VV,31,2,33,10.10646770323462,Hawkish
원금보장형/NNG,17,4,21,2.7711282412094924,Hawkish
입안자/NNG,28,8,36,2.282105610407817,Hawkish
하락/NNG;우려/NNG,26,9,35,1.8836427260508968,Hawkish
외국환/NNG,36,16,52,1.467067892405025,Hawkish
드라이브/NNG,55,23,78,1.5592025909618628,Hawkish
기아/NNG,93,22,115,2.756309373609441,Hawkish
성수기/NNG,136,31,167,2.860519474796895,Hawkish
넉넉/NNG,41,19,60,1.4070124816048195,Hawkish
분석/NNG,6357,3145,9502,1.317950975731319,Hawkish
부동산/NNG;pf/NNG;부실/NNG;우려/NNG,44,12,56,2.3907773061415227,Hawkish
입법/NNG,438,120,558,2.379910136568152,Hawkish
아쿠/NNG,12,5,17,1.5648724185653602,Hawkish
감세/NNG,223,92,315,1.5804644444749791,Hawkish
에코시티/NNG,19,6,25,2.0647622189404062,Hawkish
견고히/MAG,23,4,27,3.749173502812843,Hawkish
우려/NNG;확산/NNG,40,18,58,1.4489559431160743,Hawkish
요양/NNG,37,8,45,3.01563955661033,Hawkish
부동산/NNG;부진/NNG,59,21,80,1.831894299511037,Hawkish
희소/NNG,35,9,44,2.53567290045313,Hawkish
나온다는/VV,15,7,22,1.3972075165762146,Hawkish
구가/NNG,19,8,27,1.548571664205305,Hawkish
부동산/NNG;경기/NNG;부진/NNG,32,16,48,1.304060348804467,Hawkish
전용/NNG,1129,441,1570,1.6692563875286206,Hawkish
경제/NNG;불확실성/NNG;확대/NNG,29,9,38,2.100986117518308,Hawkish
건물/NNG,396,179,575,1.4424801623647177,Hawkish
평면/NNG,61,17,78,2.3396376846197797,Hawkish
추문/NNG,19,8,27,1.548571664205305,Hawkish
기업분석/NNG,33,14,47,1.536928268233836,Hawkish
취급고/NNG,34,2,36,11.08451296483797,Hawkish
기준선/NNG,211,27,238,5.095495066624862,Hawkish
영업력/NNG,28,4,32,4.5642112208156345,Hawkish
활짝/MAG,25,10,35,1.6300754360055838,Hawkish
사수/NNG,29,10,39,1.8908875057664771,Hawkish
적자/NNG;개선/NNG,13,6,19,1.4127320445381726,Hawkish
우려/NNG;감소/NNG,36,8,44,2.9341357848100507,Hawkish
경제/NNG;선순환/NNG,14,4,18,2.282105610407817,Hawkish
힘쓰/VV,68,30,98,1.4779350619783955,Hawkish
폭증/NNG,42,21,63,1.304060348804467,Hawkish
변조/NNG,19,1,20,12.388573313642436,Hawkish
증세/NNG,40,16,56,1.6300754360055838,Hawkish
물품/NNG,43,21,64,1.335109404728383,Hawkish
긴축정책/NNG;전환/NNG,14,3,17,3.042807480543756,Hawkish
결제수수료/NNG,24,12,36,1.3040603488044669,Hawkish
가계/NNG;대출/NNG;줄/VV,43,9,52,3.11525527769956,Hawkish
진흥/NNG,75,31,106,1.5774923574247584,Hawkish
교도/NNG,25,7,32,2.328679194293691,Hawkish
우발채무/NNG,141,57,198,1.612916747205525,Hawkish
이듬해/NNG,46,18,64,1.6662993345834856,Hawkish
연출/NNG,89,30,119,1.934356184059959,Hawkish
투자성향/NNG,104,39,143,1.7387471317392893,Hawkish
저금리정책/NNG,39,16,55,1.589323550105444,Hawkish
온누리상품권/NNG,57,5,62,7.433143988185462,Hawkish
안정/NNG;추세/NNG,28,10,38,1.8256844883262535,Hawkish
소액투자자/NNG,25,11,36,1.481886760005076,Hawkish
서비스면적/NNG,27,7,34,2.514973529837186,Hawkish
개장후/NNG,13,6,19,1.4127320445381726,Hawkish
슬로건/NNG,25,9,34,1.811194928895093,Hawkish
관리형토지신탁/NNG,14,7,21,1.3040603488044669,Hawkish
제품군/NNG,56,9,65,4.0570766407250085,Hawkish
세계/NNG;경제/NNG;완만/NNG;성장/NNG,29,1,30,18.908875057664773,Hawkish
브루킹스연구소/NNG,14,3,17,3.042807480543756,Hawkish
폐해/NNG,16,5,21,2.0864965580871475,Hawkish
아이러니/NNG,17,6,23,1.847418827472995,Hawkish
응답기업/NNG,41,4,45,6.683309287622894,Hawkish
가격/NNG;하락/NNG;둔화/NNG,30,3,33,6.520301744022334,Hawkish
와인/NNG,25,8,33,2.03759429500698,Hawkish
수집/NNG,46,15,61,1.9995592015001824,Hawkish
소비자/NNG;물가/NNG;예상/NNG;상회/NNG,27,3,30,5.868271569620101,Hawkish
출연료/NNG,23,7,30,2.142384858750196,Hawkish
임신/NNG,21,9,30,1.5214037402718783,Hawkish
위치/NNG,614,272,886,1.4718622319226888,Hawkish
멈춰/VV,22,6,28,2.3907773061415227,Hawkish
수상/NNG,113,51,164,1.4446943079892625,Hawkish
운전자/NNG,31,11,42,1.8375395824062943,Hawkish
보스턴/NNG,34,11,45,2.0153659936069035,Hawkish
매입계획/NNG,28,14,42,1.3040603488044669,Hawkish
수요/NNG;회복/NNG,87,25,112,2.2690650069197726,Hawkish
평탄/NNG,20,4,24,3.260150872011168,Hawkish
손익/NNG;감소/NNG,18,3,21,3.912181046413401,Hawkish
민간/NNG;소비/NNG;위축/NNG,27,5,32,3.5209629417720607,Hawkish
독주/NNG,39,9,48,2.825464089076345,Hawkish
느껴/VV,40,19,59,1.3726951040047022,Hawkish
원매자/NNG,45,10,55,2.934135784810051,Hawkish
인근지역/NNG,20,5,25,2.608120697608934,Hawkish
다년간/NNG,16,3,19,3.477494263478579,Hawkish
요율/NNG,42,16,58,1.7115792078058631,Hawkish
채권시장/NNG;약세/NNG,71,30,101,1.5431380794186191,Hawkish
재무비율/NNG,30,8,38,2.4451131540083755,Hawkish
중화/NNG,77,34,111,1.4766565714403523,Hawkish
전한/VV,14,6,20,1.521403740271878,Hawkish
일제히/MAG,887,330,1217,1.7525780748326705,Hawkish
망실/NNG,38,1,39,24.777146627284875,Hawkish
후실/NNG,19,1,20,12.388573313642436,Hawkish
글로벌/NNG;위험/NNG,18,5,23,2.3473086278480406,Hawkish
공과금/NNG,25,9,34,1.811194928895093,Hawkish
소송/NNG,235,67,302,2.2869715072317143,Hawkish
채용/NNG,288,70,358,2.6826384318263323,Hawkish
군인연금/NNG,32,5,37,4.172993116174295,Hawkish
화재/NNG,21,8,29,1.7115792078058631,Hawkish
건조기/NNG,12,6,18,1.3040603488044669,Hawkish
낙찰가/NNG,61,27,88,1.4731052088346757,Hawkish
파인/NNG,35,17,52,1.342415064945775,Hawkish
배당성향/NNG,47,14,61,2.188958442636069,Hawkish
모니/NNG,59,11,70,3.4972527536119795,Hawkish
장애/NNG,65,25,90,1.695278453445807,Hawkish
주무/NNG,32,6,38,3.477494263478579,Hawkish
브랜드가치/NNG,25,7,32,2.328679194293691,Hawkish
높/VA;우려/NNG,18,9,27,1.3040603488044669,Hawkish
목소리/NNG,628,266,894,1.5393795094909877,Hawkish
식료품/NNG,293,132,425,1.4473094022716244,Hawkish
날로/MAG,19,6,25,2.0647622189404062,Hawkish
마일/NNG,39,15,54,1.695278453445807,Hawkish
체험/NNG,69,23,92,1.9560905232067003,Hawkish
관계형금융/NNG,46,4,50,7.498347005625686,Hawkish
문화유산/NNG,16,1,17,10.432482790435737,Hawkish
신설/NNG,494,114,608,2.825464089076345,Hawkish
효력상실/NNG,20,7,27,1.8629433554349528,Hawkish
지인/NNG,51,20,71,1.6626769447256953,Hawkish
수익형/NNG,80,20,100,2.608120697608934,Hawkish
트론/NNG,14,4,18,2.282105610407817,Hawkish
깜짝/MAG,324,106,430,1.992997891569091,Hawkish
자금이동/NNG,30,13,43,1.504685017851308,Hawkish
소관/NNG,24,9,33,1.738747131739289,Hawkish
교과서/NNG,29,8,37,2.363609382208097,Hawkish
신항/NNG,16,5,21,2.0864965580871475,Hawkish
형식/NNG,80,38,118,1.3726951040047022,Hawkish
가치주/NNG,72,28,100,1.6766490198914574,Hawkish
시장점검회의/NNG,15,3,18,3.260150872011167,Hawkish
ecb/NNG;금리/NNG;인하/NNG,213,104,317,1.335407953343036,Hawkish
점찍/VV,13,5,18,1.6952784534458072,Hawkish
회복/NNG;쉽/VA;않/VX,16,6,22,1.7387471317392895,Hawkish
초안/NNG,39,16,55,1.589323550105444,Hawkish
실수요/NNG,109,37,146,1.920845648914688,Hawkish
속도전/NNG,18,6,24,1.9560905232067003,Hawkish
채권/NNG;가격/NNG;하락/NNG,26,13,39,1.304060348804467,Hawkish
소매/NNG;판매/NNG;감소/NNG,27,6,33,2.9341357848100507,Hawkish
견제/NNG,72,35,107,1.3413192159131662,Hawkish
업그레이드/NNG,64,24,88,1.7387471317392895,Hawkish
줄기/NNG,12,5,17,1.5648724185653602,Hawkish
채굴/NNG,132,47,179,1.8312336812998895,Hawkish
드립니다/VV,39,18,57,1.4127320445381726,Hawkish
의복/NNG,32,8,40,2.608120697608934,Hawkish
전망/NNG;밝/VA,22,10,32,1.4344663836849136,Hawkish
민족/NNG,45,7,52,4.191622549728645,Hawkish
코앞/NNG,21,9,30,1.5214037402718783,Hawkish
미니/NNG,42,21,63,1.304060348804467,Hawkish
원화/NNG;상승/NNG,17,6,23,1.847418827472995,Hawkish
무려/MAG,209,87,296,1.566371338506515,Hawkish
기업/NNG;대출/NNG;증가/NNG,20,5,25,2.608120697608934,Hawkish
점용/NNG,41,1,42,26.733237150491576,Hawkish
유가/NNG;원달러/NNG;상승/NNG,22,4,26,3.5861659592122845,Hawkish
넘보/VV,34,13,47,1.7053096868981492,Hawkish
실적/NNG;나쁘/VA,16,3,19,3.477494263478579,Hawkish
받아들여야/VV,26,11,37,1.5411622304052792,Hawkish
기대/NNG;주가/NNG;오르/VV,14,4,18,2.282105610407817,Hawkish
다툼/NNG,24,12,36,1.3040603488044669,Hawkish
돌리/VV,277,120,397,1.505102985911822,Hawkish
실적/NNG;상향/NNG,14,7,21,1.3040603488044669,Hawkish
공고/NNG,158,52,210,1.981168606837556,Hawkish
비춰/VV,36,15,51,1.5648724185653602,Hawkish
등락폭/NNG,29,9,38,2.100986117518308,Hawkish
배당/NNG,1157,444,1601,1.6990966481607754,Hawkish
익스포저/NNG,162,51,213,2.071154671630624,Hawkish
져야/VV,14,3,17,3.042807480543756,Hawkish
악성/NNG,120,41,161,1.9083809982504396,Hawkish
마친/VV,93,46,139,1.3182349178132111,Hawkish
섭니다/VV,13,5,18,1.6952784534458072,Hawkish
설문조사/NNG,287,103,390,1.8168219422664176,Hawkish
신용등급/NNG;상향/NNG,31,13,44,1.5548411851130184,Hawkish
취임사/NNG,17,4,21,2.7711282412094924,Hawkish
직항/NNG,41,4,45,6.683309287622894,Hawkish
주택/NNG;경기/NNG;침체/NNG,16,7,23,1.4903546843479625,Hawkish
바꾼다/VV,12,5,17,1.5648724185653602,Hawkish
환율변수/NNG,15,2,17,4.890226308016751,Hawkish
위험/NNG;과도/NNG,23,2,25,7.498347005625686,Hawkish
오래/MAG,327,147,474,1.4504344695886418,Hawkish
응답률/NNG,24,4,28,3.912181046413401,Hawkish
들어선다/VV,30,12,42,1.6300754360055836,Hawkish
비디아/NNG,26,7,33,2.4218263620654388,Hawkish
시설/NNG,726,338,1064,1.4005145166154482,Hawkish
사업권/NNG,14,5,19,1.8256844883262535,Hawkish
휴전/NNG,73,24,97,1.9832584471401271,Hawkish
하방/NNG;압력/NNG,108,50,158,1.4083851767088242,Hawkish
거래선/NNG,18,1,19,11.736543139240204,Hawkish
여정/NNG,32,5,37,4.172993116174295,Hawkish
위탁매매/NNG,36,18,54,1.3040603488044669,Hawkish
협박/NNG,29,8,37,2.363609382208097,Hawkish
거둔/VV,173,52,225,2.169254234068969,Hawkish
폭포/NNG,14,3,17,3.042807480543756,Hawkish
수월/NNG,72,35,107,1.3413192159131662,Hawkish
주주/NNG,702,311,1013,1.4717851525092218,Hawkish
비밀/NNG,36,7,43,3.353298039782915,Hawkish
투자/NNG;축소/NNG,20,8,28,1.6300754360055838,Hawkish
판매가격/NNG;인상/NNG,16,3,19,3.477494263478579,Hawkish
에어/NNG,25,9,34,1.811194928895093,Hawkish
면역항암제/NNG,16,3,19,3.477494263478579,Hawkish
판매/NNG;증대/NNG,16,1,17,10.432482790435737,Hawkish
분양대금/NNG,27,10,37,1.7604814708860304,Hawkish
순유입액/NNG,21,10,31,1.3692633662446905,Hawkish
만족/NNG,176,73,249,1.572017954723193,Hawkish
배당소득/NNG,113,38,151,1.9389318344066415,Hawkish
토의/NNG,25,12,37,1.3583961966713198,Hawkish
협력/NNG,802,360,1162,1.4525783329738646,Hawkish
존재감/NNG,28,13,41,1.4043726833278876,Hawkish
귀금속/NNG,69,14,83,3.2135772881252933,Hawkish
국제/NNG;유가/NNG;강세/NNG,22,4,26,3.5861659592122845,Hawkish
부진/NNG;완화/NNG,26,3,29,5.65092817815269,Hawkish
객사/NNG,15,7,22,1.3972075165762146,Hawkish
모원/NNG,24,1,25,15.648724185653604,Hawkish
금리정상화/NNG,96,44,140,1.4226112896048728,Hawkish
한마디/NNG,59,24,83,1.6029075120721574,Hawkish
금리/NNG;인하/NNG;경계/NNG,13,5,18,1.6952784534458072,Hawkish
여의치/VA,42,20,62,1.3692633662446905,Hawkish
전방위/NNG,55,26,81,1.3792945996970325,Hawkish
할당관세/NNG,24,7,31,2.2355320265219434,Hawkish
곡법/NNG,24,1,25,15.648724185653604,Hawkish
빗나갔/VV,12,5,17,1.5648724185653602,Hawkish
부원/NNG,13,5,18,1.6952784534458072,Hawkish
견조/NNG,1042,493,1535,1.378124628249751,Hawkish
경영자/NNG,27,10,37,1.7604814708860304,Hawkish
다채/NNG,31,10,41,2.021293540646924,Hawkish
화오/NNG,47,2,49,15.322709098452489,Hawkish
장애인/NNG,21,6,27,2.2821056104078177,Hawkish
연합회/NNG,177,55,232,2.0983516521671874,Hawkish
유례/NNG,14,6,20,1.521403740271878,Hawkish
상승곡선/NNG;그리/VV,18,5,23,2.3473086278480406,Hawkish
나와도/VV,22,2,24,7.172331918424569,Hawkish
소기업낙관지수/NNG,13,6,19,1.4127320445381726,Hawkish
국유재산/NNG,42,1,43,27.38526732489381,Hawkish
유동성/NNG;흡수/NNG,14,5,19,1.8256844883262535,Hawkish
주머니/NNG,30,10,40,1.9560905232067003,Hawkish
전세가격/NNG;오르/VV,87,25,112,2.2690650069197726,Hawkish
최저/NNG;떨어/VV,29,14,43,1.350633932690341,Hawkish
수주/NNG;위축/NNG,20,2,22,6.520301744022335,Hawkish
최종안/NNG,39,13,52,1.9560905232067003,Hawkish
위험/NNG;경계/NNG,17,4,21,2.7711282412094924,Hawkish
베일리/NNG,31,12,43,1.6844112838724363,Hawkish
판매사/NNG,99,19,118,3.397420382411638,Hawkish
베어/NNG,38,13,51,1.9059343559449904,Hawkish
다루/VV,54,27,81,1.3040603488044669,Hawkish
범용/NNG,31,11,42,1.8375395824062943,Hawkish
밀도/NNG,12,5,17,1.5648724185653602,Hawkish
월급통장/NNG,14,4,18,2.282105610407817,Hawkish
투자/NNG;회복/NNG,21,3,24,4.564211220815635,Hawkish
저시/NNG,26,3,29,5.65092817815269,Hawkish
입법화/NNG,36,15,51,1.5648724185653602,Hawkish
판매/NNG;줄/VV,21,10,31,1.3692633662446905,Hawkish
위인/NNG,20,9,29,1.4489559431160743,Hawkish
경쟁심/NNG,15,7,22,1.3972075165762146,Hawkish
거품/NNG,349,169,518,1.346500182641299,Hawkish
스태그플레이션/NNG,271,42,313,4.2071470776906015,Hawkish
손상차손/NNG,13,4,17,2.119098066807259,Hawkish
재건축초과이익환수/NNG,54,11,65,3.200875401610964,Hawkish
기대/NNG;지연/NNG,26,13,39,1.304060348804467,Hawkish
품질/NNG,148,72,220,1.3402842473823688,Hawkish
공동주택/NNG,127,33,160,2.5093282469419287,Hawkish
환수/NNG,92,24,116,2.4994490018752287,Hawkish
의무/NNG,291,126,417,1.5058792123099205,Hawkish
각오/NNG,36,15,51,1.5648724185653602,Hawkish
패턴/NNG,255,124,379,1.3408685038110448,Hawkish
g7/NNG,128,49,177,1.7032624963976712,Hawkish
꺼지/VV,49,21,70,1.5214037402718783,Hawkish
중요도/NNG,54,7,61,5.029947059674372,Hawkish
돌파구/NNG,63,25,88,1.6431160394936284,Hawkish
점도/NNG,13,6,19,1.4127320445381726,Hawkish
강점/NNG,153,69,222,1.4458060388919092,Hawkish
현충일/NNG,18,9,27,1.3040603488044669,Hawkish
관광단지/NNG,34,2,36,11.08451296483797,Hawkish
투사/NNG,27,9,36,1.9560905232067003,Hawkish
정년/NNG,16,7,23,1.4903546843479625,Hawkish
재화/NNG,125,38,163,2.144836100007347,Hawkish
부동산학/NNG,42,18,60,1.5214037402718783,Hawkish
복원/NNG,40,16,56,1.6300754360055838,Hawkish
연임/NNG,62,27,89,1.4972544745532768,Hawkish
조망권/NNG,24,8,32,1.9560905232067003,Hawkish
도로/NNG,221,82,303,1.7573008358889464,Hawkish
소득/NNG;오르/VV,13,5,18,1.6952784534458072,Hawkish
외표채/NNG,82,39,121,1.3709352384867473,Hawkish
예상/NNG;낮/VA,65,28,93,1.5136414762908992,Hawkish
브렌트유/NNG,307,147,454,1.3617228812345965,Hawkish
대표지수/NNG,77,25,102,2.008252937158879,Hawkish
민주/NNG,20,10,30,1.304060348804467,Hawkish
혼자/NNG,36,17,53,1.3807697810870827,Hawkish
뉴스/NNG,1228,605,1833,1.3234595936627154,Hawkish
지시/NNG,93,29,122,2.090993317910611,Hawkish
노동시장/NNG;둔화/NNG,24,8,32,1.9560905232067003,Hawkish
화폐수량설/NNG,30,1,31,19.560905232067004,Hawkish
외래/NNG,25,2,27,8.150377180027919,Hawkish
소비/NNG;회복/NNG,60,30,90,1.3040603488044669,Hawkish
디테일/NNG,13,4,17,2.119098066807259,Hawkish
장초/NNG,206,49,255,2.7411880801400024,Hawkish
물가/NNG;떨어/VV;않/VX,20,2,22,6.520301744022335,Hawkish
들썩였/VV,16,7,23,1.4903546843479625,Hawkish
보안관/NNG,61,1,62,39.77384063853625,Hawkish
트랜스/NNG,27,12,39,1.467067892405025,Hawkish
책임감/NNG,32,13,45,1.6049973523747287,Hawkish
불식/NNG,42,16,58,1.7115792078058631,Hawkish
민간/NNG;소비/NNG;개선/NNG,17,6,23,1.847418827472995,Hawkish
비엘/NNG,14,5,19,1.8256844883262535,Hawkish
무효/NNG,74,22,96,2.1931924048075127,Hawkish
승소/NNG,12,5,17,1.5648724185653602,Hawkish
어렵/VA;금리/NNG;인하/NNG,22,8,30,1.7930829796061425,Hawkish
마진/NNG;상승/NNG,25,7,32,2.328679194293691,Hawkish
래깅/NNG,29,2,31,9.454437528832386,Hawkish
미확보/NNG,75,3,78,16.300754360055837,Hawkish
소비/NNG;심리/NNG;회복/NNG,20,3,23,4.346867829348224,Hawkish
부사장/NNG,164,74,238,1.4450398459725171,Hawkish
근절/NNG,33,7,40,3.073856536467672,Hawkish
가격/NNG;높/VV,32,13,45,1.6049973523747287,Hawkish
증권거래위원회/NNG,65,29,94,1.461446942625696,Hawkish
싱크탱크/NNG,43,14,57,2.002664107092574,Hawkish
실리콘밸리/NNG,62,20,82,2.021293540646924,Hawkish
순이익/NNG;성장/NNG,16,2,18,5.216241395217868,Hawkish
경기/NNG;좋/VA;않/VX,23,8,31,1.8745867514064212,Hawkish
교촌/NNG,16,2,18,5.216241395217868,Hawkish
절차/NNG,585,279,864,1.3671600431014572,Hawkish
스텝/NNG,63,21,84,1.9560905232067003,Hawkish
비용/NNG;늘/VV,44,22,66,1.3040603488044669,Hawkish
보답/NNG,26,10,36,1.6952784534458072,Hawkish
결제성자금/NNG,45,19,64,1.54428199200529,Hawkish
토종/NNG,48,3,51,10.432482790435737,Hawkish
기대/NNG;오르/VV,14,4,18,2.282105610407817,Hawkish
택하/VV,43,19,62,1.4756472368050548,Hawkish
시영/NNG,16,1,17,10.432482790435737,Hawkish
강소기업/NNG,28,1,29,18.256844883262534,Hawkish
선두/NNG,89,36,125,1.6119634867166326,Hawkish
모회사/NNG,161,54,215,1.9440158903474,Hawkish
법정자본금/NNG,82,1,83,53.46647430098315,Hawkish
축적/NNG,159,60,219,1.7278799621659189,Hawkish
가감/NNG,17,3,20,3.69483765494599,Hawkish
과당경쟁/NNG,38,11,49,2.252467875207716,Hawkish
외환보유액/NNG;감소/NNG,12,6,18,1.3040603488044669,Hawkish
낮/VA;위험/NNG,36,8,44,2.9341357848100507,Hawkish
금리/NNG;인하/NNG;불확실/NNG,26,5,31,3.3905569068916144,Hawkish
분대/NNG,28,9,37,2.0285383203625043,Hawkish
증여/NNG,197,61,258,2.1057367927416397,Hawkish
설치/NNG,284,97,381,1.9090367992807664,Hawkish
자금사정/NNG;악화/NNG,22,5,27,2.8689327673698277,Hawkish
낙찰/NNG,504,225,729,1.4605475906610028,Hawkish
의회예산국/NNG,14,7,21,1.3040603488044669,Hawkish
무시/NNG,125,56,181,1.4554244964335568,Hawkish
보유한도/NNG,40,2,42,13.04060348804467,Hawkish
유독/MAG,102,37,139,1.7974885888926435,Hawkish
자기자본/NNG;확충/NNG,12,5,17,1.5648724185653602,Hawkish
무방/NNG,12,5,17,1.5648724185653602,Hawkish
차인/NNG,14,3,17,3.042807480543756,Hawkish
둘러보/VV,17,6,23,1.847418827472995,Hawkish
내수/NNG;부진/NNG,247,94,341,1.713313330610124,Hawkish
전속/NNG,176,13,189,8.827485438061007,Hawkish
물건비/NNG,23,1,24,14.996694011251371,Hawkish
우려/NNG;크/VV;금리/NNG;인하/NNG,12,5,17,1.5648724185653602,Hawkish
의료보험/NNG,16,8,24,1.304060348804467,Hawkish
가요/NNG,36,18,54,1.3040603488044669,Hawkish
석유화학기업/NNG,14,5,19,1.8256844883262535,Hawkish
당선자/NNG,23,10,33,1.499669401125137,Hawkish
가시성/NNG,24,8,32,1.9560905232067003,Hawkish
산원/NNG,409,136,545,1.960884862724364,Hawkish
옥석/NNG,204,90,294,1.4779350619783955,Hawkish
정비구역/NNG,27,8,35,2.200601838607538,Hawkish
빗나간/VV,14,3,17,3.042807480543756,Hawkish
경제/NNG;성장/NNG;금융안정/NNG,43,1,44,28.03729749929604,Hawkish
불패/NNG,23,3,26,4.998898003750457,Hawkish
조합/NNG,427,181,608,1.538214831324606,Hawkish
바디/NNG,17,4,21,2.7711282412094924,Hawkish
가격대/NNG,62,24,86,1.6844112838724363,Hawkish
바이백/NNG,72,29,101,1.6188335364469246,Hawkish
종식/NNG,41,14,55,1.9095169393208264,Hawkish
재생에너지/NNG,73,25,98,1.903928109254522,Hawkish
내수/NNG;침체/NNG,105,39,144,1.7554658541598591,Hawkish
역습/NNG,14,5,19,1.8256844883262535,Hawkish
구도심/NNG,33,4,37,5.379248938818426,Hawkish
경기/NNG;불확실성/NNG,66,29,95,1.483930741743014,Hawkish
눈여겨/VV,79,27,106,1.9077919917694977,Hawkish
닫기/VV,18,4,22,2.9341357848100507,Hawkish
기대/NNG;인플레이션/NNG;오르/VV,19,4,23,3.0971433284106094,Hawkish
분도/NNG,12,5,17,1.5648724185653602,Hawkish
섣불/MAG,104,30,134,2.260371271261076,Hawkish
불완전판매비율/NNG,47,1,48,30.645418196904977,Hawkish
통폐합/NNG,26,7,33,2.4218263620654388,Hawkish
실업수당/NNG,61,11,72,3.615803694412386,Hawkish
영업외수익/NNG,72,3,75,15.648724185653604,Hawkish
편대/NNG,16,1,17,10.432482790435737,Hawkish
여주/NNG,60,3,63,13.040603488044669,Hawkish
행보/NNG,265,127,392,1.3605354032802508,Hawkish
전망/NNG;넘/VV,66,17,83,2.531411265326318,Hawkish
금융사별/NNG,22,11,33,1.3040603488044669,Hawkish
수입/NNG;물가/NNG;상승/NNG,75,27,102,1.8111949288950928,Hawkish
고루/MAG,19,9,28,1.3765081459602708,Hawkish
예정자/NNG,20,8,28,1.6300754360055838,Hawkish
지지부진/NNG,121,54,175,1.461030575975375,Hawkish
인력/NNG,398,153,551,1.6961307804711694,Hawkish
지역구/NNG,20,6,26,2.173433914674112,Hawkish
국책연구기관/NNG,135,30,165,2.9341357848100507,Hawkish
시중/NNG;금리/NNG;상승/NNG,20,10,30,1.304060348804467,Hawkish
순매도금액/NNG,16,8,24,1.304060348804467,Hawkish
일희일비/NNG,32,9,41,2.318329508985719,Hawkish
부연/NNG,192,68,260,1.8410263747827769,Hawkish
순이자마진/NNG;개선/NNG,42,7,49,3.9121810464134015,Hawkish
전문기업/NNG,198,53,251,2.435886311917778,Hawkish
발목/NNG,178,55,233,2.1102067462472283,Hawkish
일지/NNG,26,9,35,1.8836427260508968,Hawkish
만든다/VV,17,1,18,11.08451296483797,Hawkish
덮치/VV,21,7,28,1.9560905232067007,Hawkish
최대/NNG;감소/NNG,17,8,25,1.3855641206047462,Hawkish
천국/NNG,18,9,27,1.3040603488044669,Hawkish
지체/NNG,71,30,101,1.5431380794186191,Hawkish
시카고상업거래소/NNG,35,11,46,2.0746414640071067,Hawkish
합한/VV,44,18,62,1.5938515374276818,Hawkish
지오/NNG,47,8,55,3.830677274613122,Hawkish
힘쓸/VV,16,6,22,1.7387471317392895,Hawkish
세밀/NNG,59,14,73,2.7478414492665557,Hawkish
인플레이션/NNG;떨어/VV,12,5,17,1.5648724185653602,Hawkish
과연/MAG,118,55,173,1.398901101444792,Hawkish
정무/NNG,15,2,17,4.890226308016751,Hawkish
실정/NNG,96,44,140,1.4226112896048728,Hawkish
뉴욕/NNG,900,392,1292,1.4970080534745158,Hawkish
의사소통/NNG,25,6,31,2.71679239334264,Hawkish
선별/NNG,179,74,253,1.5772081245675649,Hawkish
임의경매/NNG,50,14,64,2.328679194293691,Hawkish
견해차/NNG,15,5,20,1.9560905232067003,Hawkish
자본비용/NNG,35,7,42,3.260150872011168,Hawkish
건설현장/NNG,40,8,48,3.260150872011168,Hawkish
식사/NNG,35,16,51,1.426316006504886,Hawkish
특혜/NNG,21,9,30,1.5214037402718783,Hawkish
월단위/NNG,28,13,41,1.4043726833278876,Hawkish
건설/NNG;투자/NNG;회복/NNG,15,4,19,2.4451131540083755,Hawkish
현대/NNG,558,183,741,1.9881575809641872,Hawkish
비수기/NNG,93,31,124,1.9560905232067003,Hawkish
보유세/NNG,33,4,37,5.379248938818426,Hawkish
숙명/NNG,25,7,32,2.328679194293691,Hawkish
감리/NNG,26,10,36,1.6952784534458072,Hawkish
기상/NNG,71,32,103,1.4466919494549555,Hawkish
퍼져/VV,29,9,38,2.100986117518308,Hawkish
용이/NNG,94,41,135,1.4948984486295107,Hawkish
자생력/NNG,56,15,71,2.434245984435005,Hawkish
적자/NNG;축소/NNG,14,6,20,1.521403740271878,Hawkish
타운/NNG,230,59,289,2.541812544279894,Hawkish
노사/NNG,55,18,73,1.9923144217846025,Hawkish
바젤iii/NNG,22,7,29,2.049237690978448,Hawkish
전쟁/NNG,833,377,1210,1.440692666517402,Hawkish
영업외비용/NNG,39,3,42,8.476392267229036,Hawkish
첫해/NNG,24,7,31,2.2355320265219434,Hawkish
높/VA;상승/NNG,52,17,69,1.9944452393480083,Hawkish
전세시장/NNG;불안/NNG,19,5,24,2.4777146627284874,Hawkish
지정/NNG,550,222,772,1.6153900717172451,Hawkish
저층/NNG,28,4,32,4.5642112208156345,Hawkish
요주의여신/NNG,20,1,21,13.04060348804467,Hawkish
수중/NNG,13,6,19,1.4127320445381726,Hawkish
대면/NNG,142,33,175,2.805705598942944,Hawkish
민생안정/NNG,71,22,93,2.104279199207208,Hawkish
혁신당/NNG,29,6,35,3.151479176277462,Hawkish
인근/NNG,417,171,588,1.5900384954721132,Hawkish
달러인덱스/NNG;오르/VV,25,7,32,2.328679194293691,Hawkish
매수인/NNG,22,3,25,4.7815546122830455,Hawkish
물가/NNG;인상/NNG,30,9,39,2.1734339146741117,Hawkish
임금/NNG;오르/VV,13,4,17,2.119098066807259,Hawkish
파마/NNG,72,33,105,1.422611289604873,Hawkish
정책금융/NNG,401,185,586,1.4133194591097062,Hawkish
인회/NNG,21,5,26,2.738526732489381,Hawkish
군무원/NNG,29,4,33,4.727218764416193,Hawkish
88클럽/NNG,21,1,22,13.692633662446903,Hawkish
농작물/NNG,20,1,21,13.04060348804467,Hawkish
수출/NNG;급증/NNG,26,3,29,5.65092817815269,Hawkish
기류/NNG,49,23,72,1.3891077628569324,Hawkish
레이/NNG,14,5,19,1.8256844883262535,Hawkish
기업/NNG;투자/NNG;촉진/NNG,12,5,17,1.5648724185653602,Hawkish
전망/NNG;오르/VV,43,16,59,1.7523310937060026,Hawkish
유통구조/NNG;개선/NNG,23,9,32,1.6662993345834856,Hawkish
양주/NNG,26,7,33,2.4218263620654388,Hawkish
특색/NNG,32,7,39,2.9807093686959245,Hawkish
첨단산업/NNG,144,37,181,2.537630949024909,Hawkish
어르신/NNG,43,13,56,2.1567151922535417,Hawkish
이어간/NNG,63,18,81,2.282105610407817,Hawkish
금리/NNG;인하/NNG;기대/NNG;크/VV,113,38,151,1.9389318344066415,Hawkish
총사업비/NNG,30,13,43,1.504685017851308,Hawkish
물가/NNG;우려/NNG,42,6,48,4.564211220815635,Hawkish
파생결합사채/NNG,50,6,56,5.433584786685279,Hawkish
부록/NNG,14,3,17,3.042807480543756,Hawkish
불려/VV,14,7,21,1.3040603488044669,Hawkish
속내/NNG,14,7,21,1.3040603488044669,Hawkish
성능/NNG,92,39,131,1.5381224626924483,Hawkish
투기수요/NNG,25,5,30,3.260150872011168,Hawkish
부지/NNG,248,95,343,1.7021419289658306,Hawkish
영웅/NNG,16,8,24,1.304060348804467,Hawkish
앞세워/VV,83,33,116,1.639954681072284,Hawkish
처방/NNG,40,18,58,1.4489559431160743,Hawkish
환율효과/NNG,95,9,104,6.882540729801353,Hawkish
갖춰/VV,57,23,80,1.6159008669968395,Hawkish
호황/NNG,309,112,421,1.7989046775918764,Hawkish
농산물/NNG;가격/NNG;오르/VV,17,1,18,11.08451296483797,Hawkish
컬러/NNG,20,2,22,6.520301744022335,Hawkish
신세/NNG,26,6,32,2.825464089076345,Hawkish
금리/NNG;인하/NNG;기대/NNG;꺾/VV,62,16,78,2.526616925808655,Hawkish
소비자/NNG;물가/NNG;금리/NNG;인하/NNG,14,3,17,3.042807480543756,Hawkish
링컨/NNG,14,4,18,2.282105610407817,Hawkish
고향/NNG,19,7,26,1.7697961876632051,Hawkish
눈치보/VV,35,10,45,2.282105610407817,Hawkish
키스/NNG,89,17,106,3.413569736576399,Hawkish
한중일/NNG,19,6,25,2.0647622189404062,Hawkish
정보기술/NNG,152,65,217,1.524747484755992,Hawkish
대출/NNG;연체율/NNG;상승/NNG,39,12,51,2.119098066807259,Hawkish
인수금액/NNG,24,4,28,3.912181046413401,Hawkish
실적/NNG;양호/NNG,28,12,40,1.521403740271878,Hawkish
칭한/VV,25,5,30,3.260150872011168,Hawkish
예단/NNG,185,60,245,2.010426371073553,Hawkish
선주/NNG,15,2,17,4.890226308016751,Hawkish
노바/NNG,33,8,41,2.689624469409213,Hawkish
지표/NNG;안정/NNG,19,5,24,2.4777146627284874,Hawkish
미분양/NNG;주택/NNG;증가/NNG,14,3,17,3.042807480543756,Hawkish
경기/NNG;침체/NNG;빠지/VV,14,4,18,2.282105610407817,Hawkish
돌입/NNG,281,100,381,1.8322047900702765,Hawkish
젊은층/NNG,79,34,113,1.51501128758166,Hawkish
fed/NNG;통화정책/NNG;완화/NNG,28,7,35,2.6081206976089337,Hawkish
언어/NNG,45,16,61,1.833834865506282,Hawkish
처지/NNG,38,15,53,1.6518097751523249,Hawkish
금배지/NNG,16,8,24,1.304060348804467,Hawkish
임차권등기/NNG,48,1,49,31.29744837130721,Hawkish
방어/NNG,400,197,597,1.3239191358420983,Hawkish
재정전략회의/NNG,14,5,19,1.8256844883262535,Hawkish
응답비율/NNG,29,13,42,1.454528850589598,Hawkish
취향/NNG,22,11,33,1.3040603488044669,Hawkish
강자/NNG,32,14,46,1.4903546843479625,Hawkish
손익분기점/NNG,35,15,50,1.521403740271878,Hawkish
결정지/VV,15,7,22,1.3972075165762146,Hawkish
순금/NNG,30,6,36,3.260150872011167,Hawkish
이렇/VA,125,60,185,1.3583961966713196,Hawkish
랜드마크/NNG,43,17,60,1.6492527940762378,Hawkish
제품/NNG;확대/NNG,27,1,28,17.604814708860303,Hawkish
개정/NNG,616,284,900,1.4142626318020275,Hawkish
경제매체/NNG,31,15,46,1.3475290270979492,Hawkish
결과물/NNG,37,11,48,2.1931924048075127,Hawkish
지수/NNG;오르/VV,188,85,273,1.4421373269131752,Hawkish
귀추/NNG,14,6,20,1.521403740271878,Hawkish
저가/NNG,49,8,57,3.99368481821368,Hawkish
사이니지/NNG,22,1,23,14.344663836849138,Hawkish
설계사/NNG,153,27,180,3.6948376549459896,Hawkish
수입기업/NNG,15,2,17,4.890226308016751,Hawkish
제조업/NNG;지표/NNG;둔화/NNG,19,1,20,12.388573313642436,Hawkish
사업주/NNG,111,5,116,14.475069871729584,Hawkish
생계형/NNG,22,9,31,1.5938515374276818,Hawkish
보험료/NNG,398,117,515,2.2180171744622985,Hawkish
든든/NNG,94,26,120,2.357339861300382,Hawkish
자본비율/NNG;개선/NNG,13,4,17,2.119098066807259,Hawkish
소속/NNG,140,60,200,1.521403740271878,Hawkish
입학/NNG,19,8,27,1.548571664205305,Hawkish
워크숍/NNG,27,6,33,2.9341357848100507,Hawkish
반대매매/NNG,39,6,45,4.238196133614518,Hawkish
신숙/NNG,21,1,22,13.692633662446903,Hawkish
복지/NNG,318,158,476,1.3123138953158875,Hawkish
티맥스/NNG,48,1,49,31.29744837130721,Hawkish
민간/NNG;소비/NNG;회복/NNG,36,14,50,1.6766490198914574,Hawkish
경기/NNG;불황/NNG,60,24,84,1.6300754360055836,Hawkish
허가/NNG,163,52,215,2.0438638159146936,Hawkish
혹한기/NNG,38,7,45,3.5395923753264107,Hawkish
매입소각/NNG,65,31,96,1.3671600431014574,Hawkish
절실/NNG,84,35,119,1.5648724185653606,Hawkish
강성/NNG,19,6,25,2.0647622189404062,Hawkish
지사/NNG,66,18,84,2.3907773061415227,Hawkish
양배추/NNG,18,4,22,2.9341357848100507,Hawkish
면적/NNG,301,79,380,2.484317499937624,Hawkish
소비자/NNG;많/VA,19,1,20,12.388573313642436,Hawkish
지방은행/NNG,492,149,641,2.153012387959053,Hawkish
고용/NNG;둔화/NNG,68,33,101,1.343577329071269,Hawkish
집값/NNG;바닥/NNG,26,9,35,1.8836427260508968,Hawkish
위상/NNG,108,44,152,1.600437700805482,Hawkish
초석/NNG,24,12,36,1.3040603488044669,Hawkish
탕정/NNG,16,8,24,1.304060348804467,Hawkish
갇혀/VV,33,13,46,1.6551535196364389,Hawkish
수출/NNG;높/VA;증가/NNG,31,6,37,3.368822567744873,Hawkish
봉투/NNG,23,3,26,4.998898003750457,Hawkish
줄줄이/MAG,199,75,274,1.730053396080593,Hawkish
부흥/NNG,18,6,24,1.9560905232067003,Hawkish
저지/NNG,45,22,67,1.333698084004569,Hawkish
생성/NNG,210,99,309,1.383094309338071,Hawkish
대출/NNG;급증/NNG,15,3,18,3.260150872011167,Hawkish
사이즈/NNG,12,5,17,1.5648724185653602,Hawkish
글로벌/NNG;수요/NNG;회복/NNG,15,7,22,1.3972075165762146,Hawkish
하락/NNG;멈추/VV;상승/NNG,14,3,17,3.042807480543756,Hawkish
매출/NNG;상승/NNG,36,8,44,2.9341357848100507,Hawkish
이익/NNG;감소/NNG,29,10,39,1.8908875057664771,Hawkish
판매가격/NNG;하락/NNG,30,9,39,2.1734339146741117,Hawkish
경과물/NNG,13,5,18,1.6952784534458072,Hawkish
면책/NNG,42,11,53,2.489569756808528,Hawkish
금융투자업/NNG,13,5,18,1.6952784534458072,Hawkish
가계/NNG;부채/NNG;관리/NNG;강화/NNG,15,2,17,4.890226308016751,Hawkish
법인자금/NNG,13,5,18,1.6952784534458072,Hawkish
경제/NNG;지표/NNG;양호/NNG,12,6,18,1.3040603488044669,Hawkish
들어맞/VV,20,6,26,2.173433914674112,Hawkish
수주/NNG;부진/NNG,17,6,23,1.847418827472995,Hawkish
다투/VV,17,8,25,1.3855641206047462,Hawkish
기지/NNG,54,23,77,1.5308534529443742,Hawkish
교사/NNG,25,7,32,2.328679194293691,Hawkish
순이익/NNG;소폭/MAG;감소/NNG,15,2,17,4.890226308016751,Hawkish
자금/NNG;최대/NNG,17,7,24,1.58350185211971,Hawkish
건설/NNG;경기/NNG;둔화/NNG,16,3,19,3.477494263478579,Hawkish
지수/NNG;떨어/VV,45,21,66,1.3972075165762148,Hawkish
글로벌/NNG;수요/NNG;둔화/NNG,16,6,22,1.7387471317392895,Hawkish
빈틈없이/MAG,16,3,19,3.477494263478579,Hawkish
전락/NNG,29,13,42,1.454528850589598,Hawkish
적자/NNG;확대/NNG,19,8,27,1.548571664205305,Hawkish
부동산/NNG;가격/NNG;하락/NNG,32,16,48,1.304060348804467,Hawkish
농협/NNG,680,274,954,1.6181770751588276,Hawkish
재료비/NNG,36,11,47,2.133916934407309,Hawkish
원재료/NNG,159,54,213,1.9198666246287983,Hawkish
조망/NNG,49,19,68,1.6815515024057603,Hawkish
금산분리/NNG,37,16,53,1.507819778305165,Hawkish
사업부문/NNG,226,62,288,2.3767551518533026,Hawkish
한눈/NNG,34,7,41,3.16700370423942,Hawkish
공제제도/NNG,13,4,17,2.119098066807259,Hawkish
서구/NNG,33,7,40,3.073856536467672,Hawkish
영업이익/NNG;개선/NNG,35,14,49,1.6300754360055838,Hawkish
수협/NNG,76,15,91,3.3036195503046497,Hawkish
모임/NNG,270,56,326,3.143716912296483,Hawkish
환기/NNG,24,10,34,1.5648724185653602,Hawkish
강하/VA;경제/NNG;성장/NNG,18,5,23,2.3473086278480406,Hawkish
도미노/NNG,21,5,26,2.738526732489381,Hawkish
초과유동성/NNG,18,1,19,11.736543139240204,Hawkish
전사/NNG,93,38,131,1.5957580584054665,Hawkish
마지노선/NNG,39,19,58,1.3383777264045846,Hawkish
순이자마진/NNG;하락/NNG,16,7,23,1.4903546843479625,Hawkish
재정/NNG;적자/NNG;증가/NNG,16,7,23,1.4903546843479625,Hawkish
환경/NNG;개선/NNG,101,21,122,3.135954648315504,Hawkish
건너/VV,47,19,66,1.612916747205525,Hawkish
결의/NNG,165,25,190,4.303399151054741,Hawkish
일정금액/NNG,27,13,40,1.3542165160661772,Hawkish
제보/NNG,1555,749,2304,1.3536808026641831,Hawkish
가격/NNG;밀/VV;오르/VV,15,5,20,1.9560905232067003,Hawkish
스탠바이/NNG,20,1,21,13.04060348804467,Hawkish
공동투자/NNG,24,9,33,1.738747131739289,Hawkish
갉아먹/VV,16,5,21,2.0864965580871475,Hawkish
단정/NNG,49,16,65,1.99684240910684,Hawkish
관할/NNG,22,10,32,1.4344663836849136,Hawkish
건설/NNG;경기/NNG;부진/NNG,22,9,31,1.5938515374276818,Hawkish
강하/VA;회복/NNG,27,9,36,1.9560905232067003,Hawkish
순대/NNG,13,5,18,1.6952784534458072,Hawkish
배민/NNG,17,6,23,1.847418827472995,Hawkish
부촌/NNG,24,2,26,7.824362092826802,Hawkish
운항/NNG,53,4,57,8.639399810829595,Hawkish
구매/NNG;심리/NNG;위축/NNG,19,1,20,12.388573313642436,Hawkish
개구리/NNG,24,2,26,7.824362092826802,Hawkish
고개/NNG,151,67,218,1.469500840816974,Hawkish
중계/NNG,70,26,96,1.7554658541598596,Hawkish
자본잠식/NNG,83,28,111,1.9328037312637636,Hawkish
이튿날/NNG,37,5,42,4.825023290576528,Hawkish
원유/NNG;수요/NNG;증가/NNG,12,6,18,1.3040603488044669,Hawkish
다중채무자/NNG,140,38,178,2.402216432008229,Hawkish
사무/NNG,50,9,59,3.622389857790186,Hawkish
제금/NNG,48,4,52,7.824362092826802,Hawkish
장례비/NNG,19,1,20,12.388573313642436,Hawkish
뛰어들/VV,84,36,120,1.5214037402718783,Hawkish
찬바람/NNG,25,6,31,2.71679239334264,Hawkish
외평기금/NNG,20,7,27,1.8629433554349528,Hawkish
fed/NNG;인플레이션/NNG;둔화/NNG,16,4,20,2.608120697608934,Hawkish
질의/NNG,82,15,97,3.564431620065543,Hawkish
징후/NNG,132,47,179,1.8312336812998895,Hawkish
본점/NNG,254,114,368,1.452768985071643,Hawkish
범죄/NNG,113,21,134,3.508543319402494,Hawkish
구청장/NNG,14,3,17,3.042807480543756,Hawkish
매가/NNG,28,9,37,2.0285383203625043,Hawkish
도보/NNG,87,24,111,2.363609382208097,Hawkish
위헌/NNG,32,13,45,1.6049973523747287,Hawkish
막론/NNG,17,6,23,1.847418827472995,Hawkish
금리/NNG;인하/NNG;미루/VV,102,42,144,1.5835018521197095,Hawkish
fed/NNG;금리/NNG;인하/NNG;아니/VCN,15,5,20,1.9560905232067003,Hawkish
서비스업/NNG;생산/NNG;감소/NNG,19,2,21,6.194286656821219,Hawkish
숙련/NNG,35,11,46,2.0746414640071067,Hawkish
대손비용/NNG;줄/VV,17,1,18,11.08451296483797,Hawkish
전입/NNG,27,7,34,2.514973529837186,Hawkish
은산분리/NNG,13,5,18,1.6952784534458072,Hawkish
손실/NNG;부담/NNG,27,10,37,1.7604814708860304,Hawkish
통화정책/NNG;긴축/NNG,41,12,53,2.2277697625409645,Hawkish
안건/NNG,156,33,189,3.082324460810558,Hawkish
코리아디스카운트/NNG,97,34,131,1.860203732853431,Hawkish
준주거지역/NNG,14,6,20,1.521403740271878,Hawkish
경기/NNG;저하/NNG,14,7,21,1.3040603488044669,Hawkish
생필품/NNG,27,4,31,4.401203677215076,Hawkish
지켜냈/VV,17,7,24,1.58350185211971,Hawkish
전셋집/NNG,43,3,46,9.34576583309868,Hawkish
예비타당성조사/NNG,26,6,32,2.825464089076345,Hawkish
대학/NNG,133,56,189,1.5485716642053045,Hawkish
경기/NNG;부정적/VAX,22,10,32,1.4344663836849136,Hawkish
학동/NNG,12,5,17,1.5648724185653602,Hawkish
미상환/NNG,20,9,29,1.4489559431160743,Hawkish
주액/NNG,26,10,36,1.6952784534458072,Hawkish
esg투자/NNG,16,3,19,3.477494263478579,Hawkish
부진/NNG;높/VA,26,1,27,16.952784534458072,Hawkish
자동차금융/NNG,41,16,57,1.6708273219057237,Hawkish
초중/NNG,23,10,33,1.499669401125137,Hawkish
패스트트랙/NNG,24,10,34,1.5648724185653602,Hawkish
따내/VV,17,8,25,1.3855641206047462,Hawkish
경관/NNG,32,7,39,2.9807093686959245,Hawkish
중후/NNG,17,5,22,2.216902592967594,Hawkish
장년/NNG,14,3,17,3.042807480543756,Hawkish
시도/NNG,451,200,651,1.4703280432770365,Hawkish
최고점/NNG,87,30,117,1.890887505766477,Hawkish
무역업/NNG,15,2,17,4.890226308016751,Hawkish
공기/NNG,47,10,57,3.064541819690497,Hawkish
부대/NNG,45,15,60,1.9560905232067003,Hawkish
숏커버/NNG,23,5,28,2.999338802250274,Hawkish
구도/NNG,122,46,168,1.7292974190667934,Hawkish
장내/NNG,64,32,96,1.304060348804467,Hawkish
퇴직연금제도/NNG,16,3,19,3.477494263478579,Hawkish
실거주/NNG,128,24,152,3.477494263478579,Hawkish
기저효과/NNG,421,205,626,1.3390473337723916,Hawkish
인베스트먼트/NNG,146,68,214,1.3999471391577367,Hawkish
심하/VA,250,120,370,1.3583961966713196,Hawkish
어쩌/VV,15,5,20,1.9560905232067003,Hawkish
판매수수료/NNG,45,4,49,7.335339462025128,Hawkish
설비/NNG;투자/NNG;상승/NNG,16,2,18,5.216241395217868,Hawkish
협의/NNG,401,168,569,1.5563339281862836,Hawkish
여가/NNG,50,10,60,3.260150872011168,Hawkish
후인/NNG,15,6,21,1.6300754360055836,Hawkish
아트/NNG,46,9,55,3.332598669166971,Hawkish
자사주/NNG,495,113,608,2.8562383745938544,Hawkish
가사/NNG,40,18,58,1.4489559431160743,Hawkish
이미지/NNG,92,30,122,1.9995592015001824,Hawkish
위례/NNG,72,33,105,1.422611289604873,Hawkish
대손비용/NNG;감소/NNG,25,1,26,16.300754360055837,Hawkish
버거/NNG,54,4,58,8.802407354430152,Hawkish
치마/NNG,37,1,38,24.12511645288264,Hawkish
인플레이션/NNG;억제/NNG,21,7,28,1.9560905232067007,Hawkish
가동/NNG,240,83,323,1.885388456102844,Hawkish
권유/NNG,232,26,258,5.818115402358392,Hawkish
투자의견/NNG,171,71,242,1.5703825327152383,Hawkish
투자기회/NNG,81,40,121,1.3203611031645228,Hawkish
권대/NNG,27,13,40,1.3542165160661772,Hawkish
걷혀/VV,31,11,42,1.8375395824062943,Hawkish
금리/NNG;인하/NNG;쉽/VA;않/VX,26,13,39,1.304060348804467,Hawkish
경제/NNG;수출/NNG;증가/NNG,14,7,21,1.3040603488044669,Hawkish
단지도/VA,42,10,52,2.738526732489381,Hawkish
집주인/NNG,145,72,217,1.3131163234489422,Hawkish
과잉/NNG,397,174,571,1.4876780415959008,Hawkish
고부가/NNG,82,6,88,8.911079050163858,Hawkish
의결/NNG,256,92,348,1.8143448331192584,Hawkish
적합성원칙/NNG,111,1,112,72.37534935864792,Hawkish
김치프리미엄/NNG,56,10,66,3.651368976652508,Hawkish
경기/NNG;개선/NNG,94,44,138,1.3929735544047714,Hawkish
맞불/NNG,16,4,20,2.608120697608934,Hawkish
안마/NNG,21,7,28,1.9560905232067007,Hawkish
동맹국/NNG,22,9,31,1.5938515374276818,Hawkish
재취업/NNG,26,5,31,3.3905569068916144,Hawkish
자금/NNG;조달/NNG;부담/NNG,26,6,32,2.825464089076345,Hawkish
직설/NNG,13,6,19,1.4127320445381726,Hawkish
반년/NNG,93,33,126,1.8375395824062943,Hawkish
사활/NNG,35,8,43,2.852632013009772,Hawkish
리스크온/NNG,16,3,19,3.477494263478579,Hawkish
고변동성/NNG;확대/NNG,14,4,18,2.282105610407817,Hawkish
하소연/NNG,24,8,32,1.9560905232067003,Hawkish
물가/NNG;상승/NNG;확대/NNG,12,6,18,1.3040603488044669,Hawkish
불안/NNG;우려/NNG,26,9,35,1.8836427260508968,Hawkish
큐레이션/NNG,17,2,19,5.542256482418985,Hawkish
물가/NNG;경로/NNG;불확실성/NNG,13,5,18,1.6952784534458072,Hawkish
트리플/NNG,78,6,84,8.476392267229036,Hawkish
원자/NNG,80,37,117,1.409794971680505,Hawkish
시험/NNG,52,24,76,1.4127320445381726,Hawkish
트래버스/NNG,16,1,17,10.432482790435737,Hawkish
제언/NNG,181,79,260,1.4938919185671429,Hawkish
고의/NNG,15,2,17,4.890226308016751,Hawkish
etf/NNG,4965,2466,7431,1.312785813425421,Hawkish
본지/NNG,29,12,41,1.575739588138731,Hawkish
불과/MAG,844,410,1254,1.3422279687694758,Hawkish
레몬/NNG,26,3,29,5.65092817815269,Hawkish
공인중개업소/NNG,30,3,33,6.520301744022334,Hawkish
대손충당/NNG,14,5,19,1.8256844883262535,Hawkish
각기/MAG,41,20,61,1.3366618575245786,Hawkish
서명/NNG,96,26,122,2.4074960285620928,Hawkish
층수/NNG,14,6,20,1.521403740271878,Hawkish
정유/NNG,279,84,363,2.1656716506931324,Hawkish
산업/NNG;확산/NNG,16,3,19,3.477494263478579,Hawkish
잉여금/NNG,50,20,70,1.6300754360055838,Hawkish
사업다각화/NNG,65,21,86,2.0181886350545324,Hawkish
품질관리/NNG,34,8,42,2.7711282412094924,Hawkish
면담/NNG,83,28,111,1.9328037312637636,Hawkish
fed/NNG;금리/NNG;인하/NNG;기대/NNG;살/VV,15,5,20,1.9560905232067003,Hawkish
경제/NNG;높/VA,43,13,56,2.1567151922535417,Hawkish
만회/NNG,173,42,215,2.685743337418724,Hawkish
생산/NNG;차질/NNG,16,8,24,1.304060348804467,Hawkish
내다본/VV,23,5,28,2.999338802250274,Hawkish
비농업/NNG;고용/NNG;증가/NNG,38,9,47,2.7530162919205416,Hawkish
느껴질/VV,18,4,22,2.9341357848100507,Hawkish
동학/NNG,19,7,26,1.7697961876632051,Hawkish
우회/NNG,68,21,89,2.11133580282628,Hawkish
활기/NNG,127,47,174,1.7618687691294392,Hawkish
아세안+3/NNG,33,2,35,10.758497877636852,Hawkish
준사관/NNG,29,1,30,18.908875057664773,Hawkish
농산/NNG,21,3,24,4.564211220815635,Hawkish
재배/NNG,98,6,104,10.649826181903148,Hawkish
경주/NNG,15,6,21,1.6300754360055836,Hawkish
분야/NNG,1181,552,1733,1.3950138332772424,Hawkish
금천/NNG,18,4,22,2.9341357848100507,Hawkish
제이차/NNG,32,3,35,6.954988526957158,Hawkish
심리/NNG;안정/NNG,30,9,39,2.1734339146741117,Hawkish
수비대/NNG,16,2,18,5.216241395217868,Hawkish
올리브유/NNG,15,2,17,4.890226308016751,Hawkish
가격/NNG;인하/NNG,59,22,81,1.7486263768059898,Hawkish
부영/NNG,15,2,17,4.890226308016751,Hawkish
원금손실/NNG,101,28,129,2.351965986236628,Hawkish
적립/NNG,703,266,969,1.7232226037773315,Hawkish
화주/NNG,43,5,48,5.607459499859209,Hawkish
태어나/VV,18,5,23,2.3473086278480406,Hawkish
확정/NNG,680,336,1016,1.319584876766425,Hawkish
대란/NNG,63,28,91,1.467067892405025,Hawkish
금원/NNG,52,20,72,1.6952784534458072,Hawkish
집합/NNG,96,17,113,3.6820527495655537,Hawkish
이르/VV,832,401,1233,1.352840661103886,Hawkish
이동평균/NNG,95,9,104,6.882540729801353,Hawkish
금리/NNG;인하/NNG;기대/NNG;찬물/NNG,15,4,19,2.4451131540083755,Hawkish
중량/NNG,27,1,28,17.604814708860303,Hawkish
혼례/NNG,19,1,20,12.388573313642436,Hawkish
소하천/NNG,47,1,48,30.645418196904977,Hawkish
영업망/NNG,49,3,52,10.649826181903148,Hawkish
강제경매/NNG,16,2,18,5.216241395217868,Hawkish
발령/NNG,15,7,22,1.3972075165762146,Hawkish
컨틴전시플랜/NNG,24,11,35,1.4226112896048728,Hawkish
응대/NNG,25,5,30,3.260150872011168,Hawkish
원전사태/NNG,16,1,17,10.432482790435737,Hawkish
고유가/NNG;고금리/NNG,49,5,54,6.389895709141888,Hawkish
인하/NNG;불확실성/NNG,13,6,19,1.4127320445381726,Hawkish
평수/NNG,34,14,48,1.58350185211971,Hawkish
산책로/NNG,22,6,28,2.3907773061415227,Hawkish
수익성/NNG;회복/NNG,21,10,31,1.3692633662446905,Hawkish
원가/NNG;부담/NNG,19,7,26,1.7697961876632051,Hawkish
가속/NNG,393,188,581,1.3630205241493496,Hawkish
금융정책/NNG,122,54,176,1.4731052088346757,Hawkish
손가락/NNG,19,6,25,2.0647622189404062,Hawkish
하드/NNG,16,7,23,1.4903546843479625,Hawkish
테니스/NNG,26,6,32,2.825464089076345,Hawkish
동영상/NNG,101,41,142,1.6062206735274531,Hawkish
액상/NNG,17,3,20,3.69483765494599,Hawkish
낮/VA;금리/NNG;인하/NNG,26,13,39,1.304060348804467,Hawkish
세간/NNG,17,3,20,3.69483765494599,Hawkish
예상/NNG;좋/VA,28,6,34,3.042807480543756,Hawkish
재산/NNG,141,68,209,1.352003743981102,Hawkish
금리/NNG;하락/NNG;압력/NNG,15,6,21,1.6300754360055836,Hawkish
확약/NNG,80,24,104,2.173433914674112,Hawkish
수출/NNG;증가/NNG,192,79,271,1.5846809301927698,Hawkish
전시관/NNG,40,9,49,2.8979118862321487,Hawkish
오가/VV,61,20,81,1.988692031926812,Hawkish
민자사업/NNG,83,12,95,4.509875372948781,Hawkish
심리/NNG;악화/NNG,31,11,42,1.8375395824062943,Hawkish
추후/NNG,181,79,260,1.4938919185671429,Hawkish
캐시카우/NNG,33,7,40,3.073856536467672,Hawkish
수출/NNG;호조/NNG,161,65,226,1.6150285858270703,Hawkish
실적/NNG;성장/NNG,78,25,103,2.0343341441349683,Hawkish
잡화/NNG,16,7,23,1.4903546843479625,Hawkish
들어간다/VV,20,10,30,1.304060348804467,Hawkish
소문/NNG,42,17,59,1.61089807793493,Hawkish
하락장/NNG,49,15,64,2.129965236380629,Hawkish
법률/NNG,188,91,279,1.3470513493145044,Hawkish
치킨/NNG,73,21,94,2.2665810824458594,Hawkish
참패/NNG,82,20,102,2.673323715049157,Hawkish
적립금/NNG,192,76,268,1.6472341248056426,Hawkish
모험자본/NNG,29,2,31,9.454437528832386,Hawkish
민간/NNG;소비/NNG;증가/NNG,47,12,59,2.553784849742081,Hawkish
셈법/NNG,49,9,58,3.5499420606343826,Hawkish
사잇돌대출/NNG,49,23,72,1.3891077628569324,Hawkish
청룡/NNG,14,5,19,1.8256844883262535,Hawkish
순차/NNG,97,44,141,1.437430157204924,Hawkish
곤혹/NNG,28,5,33,3.651368976652508,Hawkish
매수의견/NNG,17,6,23,1.847418827472995,Hawkish
불판/NNG,18,1,19,11.736543139240204,Hawkish
역마진/NNG,48,23,71,1.3607586248394437,Hawkish
수요/NNG;감소/NNG,130,46,176,1.842693971136747,Hawkish
선보일/VV,54,21,75,1.6766490198914574,Hawkish
자치/NNG,71,29,100,1.5963497373296065,Hawkish
예측가능성/NNG,46,15,61,1.9995592015001824,Hawkish
정주/NNG,38,19,57,1.304060348804467,Hawkish
지수/NNG;급등/NNG,21,8,29,1.7115792078058631,Hawkish
건전성/NNG;우려/NNG,29,8,37,2.363609382208097,Hawkish
김치/NNG,20,8,28,1.6300754360055838,Hawkish
균열/NNG,24,8,32,1.9560905232067003,Hawkish
공급원/NNG,20,1,21,13.04060348804467,Hawkish
가온/NNG,15,4,19,2.4451131540083755,Hawkish
사양/NNG,32,6,38,3.477494263478579,Hawkish
양자/NNG,138,42,180,2.142384858750196,Hawkish
총파업/NNG,17,5,22,2.216902592967594,Hawkish
부동산신탁/NNG,108,40,148,1.7604814708860304,Hawkish
잡음/NNG,22,10,32,1.4344663836849136,Hawkish
기쁘/VA,24,6,30,2.6081206976089337,Hawkish
가락/NNG,17,2,19,5.542256482418985,Hawkish
곰곰/MAG,18,5,23,2.3473086278480406,Hawkish
금융지원/NNG,709,262,971,1.7644633345465024,Hawkish
무역지수/NNG,18,9,27,1.3040603488044669,Hawkish
액면가/NNG,33,6,39,3.586165959212284,Hawkish
이표/NNG,84,28,112,1.9560905232067007,Hawkish
공급/NNG;불안/NNG,13,4,17,2.119098066807259,Hawkish
우려/NNG;불확실성/NNG,14,3,17,3.042807480543756,Hawkish
도강/NNG,43,8,51,3.504662187412005,Hawkish
대출/NNG;줄/VV,30,14,44,1.3972075165762146,Hawkish
국세청/NNG,47,18,65,1.702523233161387,Hawkish
실업수당청구/NNG,460,211,671,1.4214875840048693,Hawkish
수다/NNG,27,6,33,2.9341357848100507,Hawkish
긴급회의/NNG,12,6,18,1.3040603488044669,Hawkish
용적률/NNG,150,59,209,1.6577038332260174,Hawkish
관련주식/NNG,367,159,526,1.505000465444149,Hawkish
그해/NNG,25,7,32,2.328679194293691,Hawkish
기존점/NNG,28,1,29,18.256844883262534,Hawkish
사무처장/NNG,44,9,53,3.187703074855364,Hawkish
ira/NNG,79,35,114,1.4717252507936127,Hawkish
순수출/NNG,141,59,200,1.5582416032324564,Hawkish
밸류/NNG,1545,573,2118,1.7580918315034044,Hawkish
용역/NNG,92,21,113,2.856513145000261,Hawkish
전망/NNG;많/VA,46,13,59,2.3071836940386725,Hawkish
변곡점/NNG,140,58,198,1.573865938212288,Hawkish
인지도/NNG,52,8,60,4.238196133614518,Hawkish
물동량/NNG,29,13,42,1.454528850589598,Hawkish
살포/NNG,26,6,32,2.825464089076345,Hawkish
오락가락/MAG,24,8,32,1.9560905232067003,Hawkish
전환사채/NNG,87,39,126,1.4545288505895977,Hawkish
행정처분/NNG,15,2,17,4.890226308016751,Hawkish
불씨/NNG,69,33,102,1.3633358192046698,Hawkish
세금/NNG,632,298,930,1.3828290947054078,Hawkish
성장전략/NNG,56,12,68,3.042807480543756,Hawkish
요원/NNG,50,17,67,1.9177358070653927,Hawkish
위비/NNG,119,18,137,4.310643930770321,Hawkish
순탄/NNG,41,20,61,1.3366618575245786,Hawkish
주리/NNG,113,9,122,8.18660107860582,Hawkish
임금채권/NNG,27,1,28,17.604814708860303,Hawkish
관광지/NNG,15,6,21,1.6300754360055836,Hawkish
부진/NNG;빠지/VV,13,6,19,1.4127320445381726,Hawkish
청사/NNG,49,18,67,1.7749710303171913,Hawkish
마주/MAG,38,10,48,2.4777146627284874,Hawkish
구입자금/NNG,73,17,90,2.799894278315473,Hawkish
수요/NNG;성장/NNG;둔화/NNG,21,3,24,4.564211220815635,Hawkish
프라/NNG,30,11,41,1.7782641120060911,Hawkish
바움/NNG,34,2,36,11.08451296483797,Hawkish
나선다/VV,149,73,222,1.3308561093963396,Hawkish
판매/NNG;부진/NNG,58,16,74,2.363609382208097,Hawkish
정착/NNG,159,45,204,2.3038399495545585,Hawkish
선제/NNG;자본/NNG;확충/NNG,19,3,22,4.1295244378808125,Hawkish
연이/VV,179,88,267,1.326288650204543,Hawkish
즐길/VV,48,17,65,1.8410263747827769,Hawkish
높/VA;물가/NNG;상승/NNG,15,7,22,1.3972075165762146,Hawkish
가입금액/NNG,40,13,53,2.006246690468411,Hawkish
환경/NNG;불확실성/NNG,16,4,20,2.608120697608934,Hawkish
굳건히/MAG,25,7,32,2.328679194293691,Hawkish
동성/NNG,26,5,31,3.3905569068916144,Hawkish
고리/MAG,22,5,27,2.8689327673698277,Hawkish
공고히/MAG,44,11,55,2.6081206976089337,Hawkish
위기/NNG;확산/NNG,12,6,18,1.3040603488044669,Hawkish
흔들/VV,326,144,470,1.4761238670495007,Hawkish
금지/NNG,292,126,418,1.5110540549639064,Hawkish
예상/NNG;확대/NNG,34,6,40,3.69483765494599,Hawkish
강경/NNG,76,33,109,1.5016452501384772,Hawkish
찬밥/NNG,17,3,20,3.69483765494599,Hawkish
플러스/NNG;성장/NNG,19,9,28,1.3765081459602708,Hawkish
리얼/NNG,61,23,84,1.7292974190667934,Hawkish
건설채/NNG,39,17,56,1.4958339295110064,Hawkish
피해/NNG;방지/NNG,16,1,17,10.432482790435737,Hawkish
긴장/NNG,734,284,1018,1.685176577504364,Hawkish
도마/NNG,28,12,40,1.521403740271878,Hawkish
구성원/NNG,36,13,49,1.8056220214215697,Hawkish
금리/NNG;인하/NNG;기대/NNG;약하/VA,35,14,49,1.6300754360055838,Hawkish
높/VA;성장/NNG,71,29,100,1.5963497373296065,Hawkish
매수전략/NNG,617,48,665,8.381304533462043,Hawkish
수입/NNG;늘/VV,36,15,51,1.5648724185653602,Hawkish
피해자/NNG,669,89,758,4.901215580619036,Hawkish
출연/NNG,424,139,563,1.9889265751550145,Hawkish
인플레이션/NNG;충격/NNG,19,6,25,2.0647622189404062,Hawkish
손님/NNG,31,15,46,1.3475290270979492,Hawkish
화폐발행액/NNG,15,4,19,2.4451131540083755,Hawkish
수익성/NNG;개선/NNG,156,62,218,1.6405920517217487,Hawkish
청정/NNG,24,6,30,2.6081206976089337,Hawkish
판매대수/NNG,31,9,40,2.2458817118299157,Hawkish
고대/NNG,16,4,20,2.608120697608934,Hawkish
최다/NNG,110,54,164,1.3282096145230682,Hawkish
대화/NNG,118,53,171,1.451689822254029,Hawkish
프리미엄/NNG,748,307,1055,1.5886598386086992,Hawkish
배문/NNG,57,1,58,37.16571994092731,Hawkish
발열/NNG,19,4,23,3.0971433284106094,Hawkish
국비/NNG,15,4,19,2.4451131540083755,Hawkish
선진시장/NNG,37,18,55,1.3402842473823688,Hawkish
대출/NNG;어렵/VA,42,10,52,2.738526732489381,Hawkish
미약/NNG;증가/NNG,19,5,24,2.4777146627284874,Hawkish
전원/NNG,115,56,171,1.3389905367188724,Hawkish
주인공/NNG,40,19,59,1.3726951040047022,Hawkish
중대재해/NNG,135,23,158,3.827133632360936,Hawkish
적절/NNG,866,347,1213,1.627256861764652,Hawkish
글로벌스타/NNG,17,1,18,11.08451296483797,Hawkish
잃어버린/VV,24,11,35,1.4226112896048728,Hawkish
목도/NNG,13,6,19,1.4127320445381726,Hawkish
하이브리드/NNG,255,78,333,2.1316371086226864,Hawkish
주택담보대출/NNG;증가/NNG;확대/NNG,17,2,19,5.542256482418985,Hawkish
버텨온/VV,20,4,24,3.260150872011168,Hawkish
자금/NNG;공급/NNG;확대/NNG,40,2,42,13.04060348804467,Hawkish
전업/NNG,179,78,257,1.4963256566410228,Hawkish
예상/NNG;증가/NNG,38,9,47,2.7530162919205416,Hawkish
예상/NNG;상회/NNG,164,55,219,1.94423542912666,Hawkish
자주포/NNG,17,1,18,11.08451296483797,Hawkish
양도세/NNG,195,69,264,1.842693971136747,Hawkish
구속/NNG,40,9,49,2.8979118862321487,Hawkish
합리/NNG,96,44,140,1.4226112896048728,Hawkish
비아/NNG,23,3,26,4.998898003750457,Hawkish
출렁이/VV,56,23,79,1.5875517289793513,Hawkish
전망/NNG;불확실성/NNG;높/VA,28,3,31,6.085614961087512,Hawkish
스타트업/NNG,539,205,744,1.714362263428311,Hawkish
중도금/NNG,231,75,306,2.0082529371588795,Hawkish
크라우드펀딩/NNG,21,6,27,2.2821056104078177,Hawkish
금리/NNG;인상/NNG;종료/NNG,18,3,21,3.912181046413401,Hawkish
재경/NNG,17,4,21,2.7711282412094924,Hawkish
경제동향/NNG,250,109,359,1.4954820513812694,Hawkish
텍스트/NNG,14,5,19,1.8256844883262535,Hawkish
개수/NNG,34,12,46,1.847418827472995,Hawkish
버텨/VV,25,8,33,2.03759429500698,Hawkish
수익성/NNG,1727,795,2522,1.4164227813744117,Hawkish
방배/NNG,24,5,29,3.1297448371307204,Hawkish
오븐/NNG,16,2,18,5.216241395217868,Hawkish
수사/NNG,69,25,94,1.7996032813501643,Hawkish
울퉁불퉁/MAG,75,9,84,5.4335847866852784,Hawkish
개조/NNG,17,4,21,2.7711282412094924,Hawkish
수송/NNG,36,10,46,2.3473086278480406,Hawkish
집값/NNG;내리/VV,13,4,17,2.119098066807259,Hawkish
물가/NNG;상승/NNG;충격/NNG,13,4,17,2.119098066807259,Hawkish
금리/NNG;인하/NNG;늦/VA,95,36,131,1.7206351824503383,Hawkish
신용불량자/NNG,22,10,32,1.4344663836849136,Hawkish
팝업/NNG,14,6,20,1.521403740271878,Hawkish
공급/NNG;부족/NNG;우려/NNG,24,9,33,1.738747131739289,Hawkish
거치/VV,551,273,824,1.3160022933905886,Hawkish
크라운/NNG,15,5,20,1.9560905232067003,Hawkish
상한선/NNG,45,21,66,1.3972075165762148,Hawkish
재건축/NNG,930,228,1158,2.6595967640091103,Hawkish
순이자마진/NNG,511,150,661,2.221249460796942,Hawkish
외화예금/NNG,63,26,89,1.5799192687438737,Hawkish
용액/NNG,14,7,21,1.3040603488044669,Hawkish
주도/NNG,1366,649,2015,1.3723778401131757,Hawkish
주택부금/NNG,43,17,60,1.6492527940762378,Hawkish
주택임대차보호법/NNG,15,4,19,2.4451131540083755,Hawkish
부스/NNG,51,14,65,2.3752527781795645,Hawkish
교란/NNG,84,31,115,1.7667914403157297,Hawkish
빼놓/VV,19,9,28,1.3765081459602708,Hawkish
하천/NNG,50,1,51,32.601508720111674,Hawkish
안팎/NNG,409,193,602,1.3817634265829717,Hawkish
증축/NNG,21,5,26,2.738526732489381,Hawkish
에이피/NNG,15,4,19,2.4451131540083755,Hawkish
정관/NNG,14,3,17,3.042807480543756,Hawkish
이율/NNG,165,59,224,1.823474216548619,Hawkish
무역/NNG;악화/NNG,15,6,21,1.6300754360055836,Hawkish
대어/NNG,59,20,79,1.9234890144865888,Hawkish
가해질/VV,21,4,25,3.4231584156117263,Hawkish
제조업/NNG;경기/NNG;위축/NNG,16,5,21,2.0864965580871475,Hawkish
한미fta/NNG,13,6,19,1.4127320445381726,Hawkish
프록시/NNG,24,1,25,15.648724185653604,Hawkish
소비자/NNG;물가/NNG;상승률/NNG;높/VA,28,8,36,2.282105610407817,Hawkish
경제/NNG;불황/NNG,13,6,19,1.4127320445381726,Hawkish
임장/NNG,16,1,17,10.432482790435737,Hawkish
원달러/NNG;강세/NNG,15,3,18,3.260150872011167,Hawkish
했었/VV,44,21,65,1.3661584606522987,Hawkish
자이/NNG,82,24,106,2.2277697625409645,Hawkish
번졌/VV,20,10,30,1.304060348804467,Hawkish
임금/NNG;증가/NNG,17,2,19,5.542256482418985,Hawkish
분조/NNG,144,1,145,93.89234511392162,Hawkish
대변인/NNG,30,11,41,1.7782641120060911,Hawkish
바뀐다/VV,39,6,45,4.238196133614518,Hawkish
물가/NNG;상승/NNG;우려/NNG;크/VV,20,3,23,4.346867829348224,Hawkish
기후변화/NNG,256,77,333,2.1677886317788544,Hawkish
일자리/NNG;늘/VV,24,9,33,1.738747131739289,Hawkish
경찰/NNG,52,20,72,1.6952784534458072,Hawkish
매도인/NNG,16,5,21,2.0864965580871475,Hawkish
시제품/NNG,15,5,20,1.9560905232067003,Hawkish
판상/NNG,46,5,51,5.998677604500548,Hawkish
현행법/NNG,44,5,49,5.737865534739655,Hawkish
기여금/NNG,30,9,39,2.1734339146741117,Hawkish
건전성/NNG;악화/NNG;우려/NNG,16,5,21,2.0864965580871475,Hawkish
수주/NNG,1305,484,1789,1.7580565652787494,Hawkish
구성비중/NNG,17,2,19,5.542256482418985,Hawkish
영업이익/NNG;줄/VV,57,17,74,2.186218820054548,Hawkish
분상/NNG,36,3,39,7.824362092826802,Hawkish
뒤처지/VV,14,7,21,1.3040603488044669,Hawkish
위험/NNG;완화/NNG,27,12,39,1.467067892405025,Hawkish
은행/NNG;가계/NNG;대출/NNG;감소/NNG,12,5,17,1.5648724185653602,Hawkish
금리/NNG;길/VA,14,3,17,3.042807480543756,Hawkish
특정금전신탁/NNG,59,14,73,2.7478414492665557,Hawkish
일맥상통/NNG,13,4,17,2.119098066807259,Hawkish
개점/NNG,12,5,17,1.5648724185653602,Hawkish
가격/NNG;살/VV,16,4,20,2.608120697608934,Hawkish
순풍/NNG,14,5,19,1.8256844883262535,Hawkish
집단소송/NNG,23,2,25,7.498347005625686,Hawkish
폭격/NNG,59,17,76,2.262928252337163,Hawkish
일컫/VV,31,10,41,2.021293540646924,Hawkish
전세가격/NNG,1173,531,1704,1.4403604417586062,Hawkish
보험설계사/NNG,40,9,49,2.8979118862321487,Hawkish
마당/NNG,18,7,25,1.6766490198914574,Hawkish
고금리정책/NNG,33,5,38,4.303399151054741,Hawkish
표지어음/NNG,37,17,54,1.4191244972283903,Hawkish
걱정/NNG,321,156,477,1.3416774742507498,Hawkish
관통/NNG,16,4,20,2.608120697608934,Hawkish
초과이익환수제/NNG,31,4,35,5.05323385161731,Hawkish
돌파/NNG,1552,754,2306,1.342109855003006,Hawkish
어울림/NNG,21,6,27,2.2821056104078177,Hawkish
인플레이션타게팅/NNG,15,4,19,2.4451131540083755,Hawkish
눈여겨보/VV,42,20,62,1.3692633662446905,Hawkish
느끼/VV,310,142,452,1.4234461553851576,Hawkish
예금자보호법/NNG,34,12,46,1.847418827472995,Hawkish
법조/NNG,16,5,21,2.0864965580871475,Hawkish
교실/NNG,16,4,20,2.608120697608934,Hawkish
병기/NNG,20,1,21,13.04060348804467,Hawkish
포트/NNG,15,5,20,1.9560905232067003,Hawkish
소비자/NNG;물가/NNG;예상/NNG;웃돌/VV,23,4,27,3.749173502812843,Hawkish
생활자금/NNG,38,6,44,4.1295244378808125,Hawkish
반짝/MAG,56,21,77,1.7387471317392893,Hawkish
지정학/NNG;위험/NNG;크/VV,35,10,45,2.282105610407817,Hawkish
매출/NNG;증대/NNG,50,11,61,2.963773520010152,Hawkish
알고리즘/NNG,50,15,65,2.1734339146741117,Hawkish
수익/NNG;개선/NNG,25,6,31,2.71679239334264,Hawkish
평형/NNG,148,62,210,1.5564591259924283,Hawkish
수요변화/NNG,21,6,27,2.2821056104078177,Hawkish
재정환율/NNG,70,29,99,1.573865938212288,Hawkish
바꾸/VV,236,108,344,1.424806677397473,Hawkish
리뉴얼/NNG,164,37,201,2.8900796919450347,Hawkish
낮/VA;상승/NNG,13,6,19,1.4127320445381726,Hawkish
만기일시상환/NNG,16,7,23,1.4903546843479625,Hawkish
곳간/NNG,22,9,31,1.5938515374276818,Hawkish
확실히/MAG,130,52,182,1.6300754360055838,Hawkish
역성장/NNG,116,53,169,1.4270849100124356,Hawkish
재개발사업/NNG,62,16,78,2.526616925808655,Hawkish
이익/NNG;줄/VV,18,9,27,1.3040603488044669,Hawkish
여간/MAG,34,11,45,2.0153659936069035,Hawkish
신흥국지수/NNG,35,11,46,2.0746414640071067,Hawkish
국립/NNG,14,4,18,2.282105610407817,Hawkish
난항/NNG,83,25,108,2.164740179015415,Hawkish
조처/NNG,38,14,52,1.7697961876632051,Hawkish
흑자전환/NNG,339,128,467,1.7268611650184154,Hawkish
보일지/VV,15,7,22,1.3972075165762146,Hawkish
예상/NNG;작/VA,23,6,29,2.4994490018752287,Hawkish
대지지분/NNG,17,1,18,11.08451296483797,Hawkish
국제/NNG;유가/NNG;상승/NNG,184,55,239,2.181337310727472,Hawkish
위기/NNG;확대/NNG,13,4,17,2.119098066807259,Hawkish
뜨겁/VA,324,134,458,1.5765505709427137,Hawkish
보육/NNG,63,25,88,1.6431160394936284,Hawkish
금리/NNG;인하/NNG;가능성/NNG;낮/VA,35,13,48,1.7554658541598596,Hawkish
가계약/NNG,15,6,21,1.6300754360055836,Hawkish
장금/NNG,157,2,159,51.18436869057533,Hawkish
기고/NNG,16,7,23,1.4903546843479625,Hawkish
수출품/NNG,28,8,36,2.282105610407817,Hawkish
판매/NNG;증가/NNG,55,24,79,1.494235816338452,Hawkish
라스트/NNG,30,7,37,2.794415033152429,Hawkish
골든타임/NNG,16,4,20,2.608120697608934,Hawkish
인수자/NNG,16,8,24,1.304060348804467,Hawkish
애로/NNG,407,117,524,2.2681733417240086,Hawkish
경쟁국/NNG,21,9,30,1.5214037402718783,Hawkish
바로잡/VV,17,6,23,1.847418827472995,Hawkish
가졌/VV,70,30,100,1.521403740271878,Hawkish
코인/NNG,580,289,869,1.308572668350503,Hawkish
매출/NNG;감소/NNG,187,61,248,1.998846600216683,Hawkish
버퍼/NNG,70,14,84,3.260150872011168,Hawkish
돌린/VV,36,8,44,2.9341357848100507,Hawkish
결심/NNG,19,8,27,1.548571664205305,Hawkish
이럴/VA,53,25,78,1.3823039697327348,Hawkish
용적률/NNG;완화/NNG,23,5,28,2.999338802250274,Hawkish
비로소/MAG,17,3,20,3.69483765494599,Hawkish
생업/NNG,20,2,22,6.520301744022335,Hawkish
후발주자/NNG,32,14,46,1.4903546843479625,Hawkish
기지개/NNG,34,12,46,1.847418827472995,Hawkish
찬물/NNG,76,11,87,4.504935750415432,Hawkish
수립/NNG,283,123,406,1.5001995069579843,Hawkish
유가/NNG;환율/NNG;상승/NNG,13,5,18,1.6952784534458072,Hawkish
대조/NNG,140,64,204,1.426316006504886,Hawkish
모시/VV,17,6,23,1.847418827472995,Hawkish
출자/NNG,237,109,346,1.4177169847094435,Hawkish
탈락/NNG,19,2,21,6.194286656821219,Hawkish
관세사/NNG,40,4,44,6.520301744022335,Hawkish
진실/NNG,40,7,47,3.7258867108699056,Hawkish
내건/VV,43,13,56,2.1567151922535417,Hawkish
방점/NNG,59,23,82,1.6725991430318163,Hawkish
핫라인/NNG,16,1,17,10.432482790435737,Hawkish
알파/NNG,102,29,131,2.2933475099664764,Hawkish
맞대응/NNG,20,3,23,4.346867829348224,Hawkish
대파/NNG,56,4,60,9.128422441631267,Hawkish
세무사/NNG,22,8,30,1.7930829796061425,Hawkish
원달러/NNG;내리/VV,31,4,35,5.05323385161731,Hawkish
매출/NNG;호조/NNG,26,4,30,4.238196133614518,Hawkish
한결/MAG,15,6,21,1.6300754360055836,Hawkish
수많/VA,56,26,82,1.4043726833278876,Hawkish
생보사/NNG,253,60,313,2.7493939020627507,Hawkish
실적/NNG;부진/NNG,147,65,212,1.4745913174942815,Hawkish
크레딧라인/NNG,17,5,22,2.216902592967594,Hawkish
예상/NNG;웃돌/VV;금리/NNG;인하/NNG,33,6,39,3.586165959212284,Hawkish
외화자산/NNG,48,15,63,2.086496558087147,Hawkish
전강후약/NNG,29,11,40,1.7189886416058884,Hawkish
무섭/VA,36,15,51,1.5648724185653602,Hawkish
금리/NNG;변동성/NNG;확대/NNG,34,14,48,1.58350185211971,Hawkish
배추/NNG,21,3,24,4.564211220815635,Hawkish
라이브러리/NNG,20,1,21,13.04060348804467,Hawkish
꿈틀/MAG,13,6,19,1.4127320445381726,Hawkish
비이/VV,234,22,256,6.935230036823756,Hawkish
구매/NNG,795,363,1158,1.4279999687321645,Hawkish
박진/NNG,113,9,122,8.18660107860582,Hawkish
되사/VV,17,3,20,3.69483765494599,Hawkish
노동자/NNG,115,28,143,2.6779810734377447,Hawkish
고용/NNG;지표/NNG;둔화/NNG,54,17,71,2.071154671630624,Hawkish
전용상품/NNG,60,16,76,2.4451131540083755,Hawkish
전망/NNG;증가/NNG,35,12,47,1.901754675339848,Hawkish
분배/NNG,130,38,168,2.230629544007641,Hawkish
제조업/NNG;경기/NNG;회복/NNG,23,7,30,2.142384858750196,Hawkish
주의보/NNG,25,8,33,2.03759429500698,Hawkish
추진/NNG,2938,1230,4168,1.5574509369054974,Hawkish
홍보/NNG,219,84,303,1.6999358118343946,Hawkish
경기/NNG;호황/NNG,17,5,22,2.216902592967594,Hawkish
가두/NNG,14,6,20,1.521403740271878,Hawkish
생산물/NNG,28,12,40,1.521403740271878,Hawkish
자금사정/NNG;개선/NNG,16,2,18,5.216241395217868,Hawkish
착수/NNG,141,70,211,1.313375065581642,Hawkish
가동률/NNG;상승/NNG,15,4,19,2.4451131540083755,Hawkish
전망/NNG;경로/NNG;불확실성/NNG,18,9,27,1.3040603488044669,Hawkish
단서/NNG,48,20,68,1.5648724185653602,Hawkish
사견/NNG,13,6,19,1.4127320445381726,Hawkish
관계개선/NNG,12,6,18,1.3040603488044669,Hawkish
경상/NNG;수지/NNG;적자/NNG,16,6,22,1.7387471317392895,Hawkish
인재/NNG,59,23,82,1.6725991430318163,Hawkish
아웃퍼폼/NNG,147,61,208,1.5712858301168575,Hawkish
미소금융/NNG,89,3,92,19.34356184059959,Hawkish
구조조정기금/NNG,16,3,19,3.477494263478579,Hawkish
제조업체인/NNG,20,9,29,1.4489559431160743,Hawkish
미수금/NNG,95,21,116,2.9496603127720085,Hawkish
나랏빚/NNG,30,6,36,3.260150872011167,Hawkish
청원/NNG,40,18,58,1.4489559431160743,Hawkish
감시/NNG,48,9,57,3.477494263478578,Hawkish
관악/NNG,17,2,19,5.542256482418985,Hawkish
열풍/NNG,270,133,403,1.3236702788616772,Hawkish
곧장/MAG,28,12,40,1.521403740271878,Hawkish
낮/VA;인하/NNG,13,6,19,1.4127320445381726,Hawkish
저소득/NNG,141,44,185,2.089460331607157,Hawkish
기울/VV,26,13,39,1.304060348804467,Hawkish
호국/NNG,27,1,28,17.604814708860303,Hawkish
구현/NNG,92,41,133,1.4630920986586702,Hawkish
무더기/NNG,31,14,45,1.4437811004620884,Hawkish
터널/NNG,47,12,59,2.553784849742081,Hawkish
직거래/NNG,24,11,35,1.4226112896048728,Hawkish
미시간대/NNG,91,42,133,1.4127320445381726,Hawkish
버티/VV,168,63,231,1.7387471317392895,Hawkish
경조사/NNG,15,4,19,2.4451131540083755,Hawkish
이끌어냈/VV,18,7,25,1.6766490198914574,Hawkish
주식발행/NNG,39,9,48,2.825464089076345,Hawkish
전라/NNG,25,4,29,4.075188590013959,Hawkish
나타난다는/VV,14,4,18,2.282105610407817,Hawkish
자금/NNG;부담/NNG;덜/VV,19,4,23,3.0971433284106094,Hawkish
영통/NNG,17,3,20,3.69483765494599,Hawkish
유동자산/NNG,16,7,23,1.4903546843479625,Hawkish
미사일/NNG,99,47,146,1.3734252609749174,Hawkish
가하/VV,138,62,200,1.4512929688307776,Hawkish
대손/NNG;부담/NNG,22,3,25,4.7815546122830455,Hawkish
돌봄/VV,50,19,69,1.7158688800058777,Hawkish
지구/NNG,293,131,424,1.4583575656477437,Hawkish
과반/NNG,66,31,97,1.3881932745337875,Hawkish
순환매/NNG,102,26,128,2.557964530347224,Hawkish
실적/NNG;호조/NNG,115,36,151,2.082874168229357,Hawkish
일찌감치/MAG,39,18,57,1.4127320445381726,Hawkish
들여/VV,35,13,48,1.7554658541598596,Hawkish
학생/NNG,62,22,84,1.8375395824062943,Hawkish
회사채/NNG;발행/NNG;수요/NNG;증가/NNG,16,1,17,10.432482790435737,Hawkish
롤오버/NNG,42,18,60,1.5214037402718783,Hawkish
환경/NNG;녹록/NNG;않/VX,22,8,30,1.7930829796061425,Hawkish
동문/NNG,50,11,61,2.963773520010152,Hawkish
긴축정책/NNG,93,30,123,2.021293540646924,Hawkish
귀환/NNG,21,1,22,13.692633662446903,Hawkish
일대/NNG,197,70,267,1.8349992051034287,Hawkish
미봉책/NNG,12,6,18,1.3040603488044669,Hawkish
고급/NNG,132,47,179,1.8312336812998895,Hawkish
떠난/VV,22,8,30,1.7930829796061425,Hawkish
방학/NNG,17,1,18,11.08451296483797,Hawkish
입성/NNG,48,15,63,2.086496558087147,Hawkish
퇴직자/NNG,12,5,17,1.5648724185653602,Hawkish
지분가치/NNG,28,13,41,1.4043726833278876,Hawkish
난감/NNG,16,2,18,5.216241395217868,Hawkish
운용자산/NNG,115,43,158,1.7438016292152758,Hawkish
환승/NNG,35,15,50,1.521403740271878,Hawkish
높/VA;금리/NNG;인하/NNG;어렵/VA,46,1,47,29.993388022502742,Hawkish
메달/NNG,17,1,18,11.08451296483797,Hawkish
부추긴/VV,14,5,19,1.8256844883262535,Hawkish
영원/NNG,29,12,41,1.575739588138731,Hawkish
매출/NNG,4882,1748,6630,1.821059102649716,Hawkish
필라델피아반도체지수/NNG;오르/VV,15,5,20,1.9560905232067003,Hawkish
고작/MAG,19,9,28,1.3765081459602708,Hawkish
판매/NNG;정체/NNG,16,1,17,10.432482790435737,Hawkish
오더/NNG,52,1,53,33.905569068916144,Hawkish
기시/NNG,24,8,32,1.9560905232067003,Hawkish
권장/NNG,19,8,27,1.548571664205305,Hawkish
중대형/NNG,204,39,243,3.410619373796298,Hawkish
알파벳/NNG,426,95,521,2.9238405715300155,Hawkish
공지/NNG,57,27,84,1.3765081459602706,Hawkish
의사록/NNG,278,138,416,1.313510061476963,Hawkish
눈치/NNG,62,25,87,1.617034832517539,Hawkish
거버넌스/NNG,46,14,60,2.142384858750196,Hawkish
산단/NNG,26,8,34,2.119098066807259,Hawkish
베타/NNG,16,4,20,2.608120697608934,Hawkish
신음/NNG,20,6,26,2.173433914674112,Hawkish
신규등록/NNG,28,9,37,2.0285383203625043,Hawkish
비밀번호/NNG,18,8,26,1.467067892405025,Hawkish
울트라/NNG,18,5,23,2.3473086278480406,Hawkish
기부금/NNG,118,15,133,5.129304038630903,Hawkish
판매가격/NNG;부진/NNG,15,3,18,3.260150872011167,Hawkish
컨센서스/NNG;웃돌/VV,12,5,17,1.5648724185653602,Hawkish
대손충당금/NNG;감소/NNG,18,1,19,11.736543139240204,Hawkish
높/VA;가격/NNG;상승/NNG,13,4,17,2.119098066807259,Hawkish
나올지/VV,25,9,34,1.811194928895093,Hawkish
특급/NNG,23,5,28,2.999338802250274,Hawkish
원주/NNG,63,9,72,4.5642112208156345,Hawkish
목표/NNG,4289,2102,6391,1.330426935305033,Hawkish
품관/NNG,23,1,24,14.996694011251371,Hawkish
현장/NNG,742,200,942,2.419031947032286,Hawkish
시장분석/NNG,20,4,24,3.260150872011168,Hawkish
반하/VV,21,3,24,4.564211220815635,Hawkish
경제/NNG;견조/NNG;성장/NNG,29,8,37,2.363609382208097,Hawkish
법제화/NNG,63,26,89,1.5799192687438737,Hawkish
관망세/NNG,270,128,398,1.3753761491297114,Hawkish
도심/NNG,218,89,307,1.5971076181987294,Hawkish
널뛰기/NNG,22,7,29,2.049237690978448,Hawkish
연재/NNG,13,6,19,1.4127320445381726,Hawkish
매출/NNG;늘/VV,110,39,149,1.83905946626271,Hawkish
듀레이션/NNG;짧/VA,19,5,24,2.4777146627284874,Hawkish
빼앗기/VV,12,5,17,1.5648724185653602,Hawkish
수주/NNG;물량/NNG;확보/NNG,20,2,22,6.520301744022335,Hawkish
제2금융권/NNG,210,72,282,1.9017546753398475,Hawkish
믿음/NNG,56,26,82,1.4043726833278876,Hawkish
커버리지비율/NNG,72,32,104,1.467067892405025,Hawkish
맡기/VV,65,32,97,1.324436291754537,Hawkish
금리/NNG;잡/VV,30,3,33,6.520301744022334,Hawkish
이익률/NNG,70,33,103,1.383094309338071,Hawkish
식업/NNG,23,5,28,2.999338802250274,Hawkish
암로/NNG,28,2,30,9.128422441631267,Hawkish
무상감자/NNG,23,6,29,2.4994490018752287,Hawkish
선명/NNG,46,5,51,5.998677604500548,Hawkish
기대/NNG;실망/NNG,13,6,19,1.4127320445381726,Hawkish
사용처/NNG,12,5,17,1.5648724185653602,Hawkish
투자금액/NNG,185,64,249,1.8847747228814564,Hawkish
내재가치/NNG,15,3,18,3.260150872011167,Hawkish
부동산/NNG;불안/NNG,14,5,19,1.8256844883262535,Hawkish
금리/NNG;고물가/NNG,136,56,192,1.58350185211971,Hawkish
순도/NNG,12,6,18,1.3040603488044669,Hawkish
수분/NNG,81,14,95,3.77246029475578,Hawkish
들이/VV,28,9,37,2.0285383203625043,Hawkish
공급계약/NNG,39,15,54,1.695278453445807,Hawkish
예금보험제도/NNG,27,1,28,17.604814708860303,Hawkish
단기자금시장/NNG,71,35,106,1.3226897823588166,Hawkish
일당/NNG,17,3,20,3.69483765494599,Hawkish
수익창출/NNG,127,52,179,1.592458310559301,Hawkish
일드/NNG,17,8,25,1.3855641206047462,Hawkish
남자/NNG,18,7,25,1.6766490198914574,Hawkish
수요/NNG;둔화/NNG,95,30,125,2.064762218940406,Hawkish
구매/NNG;부담/NNG,16,4,20,2.608120697608934,Hawkish
준비금/NNG,42,17,59,1.61089807793493,Hawkish
구제/NNG,145,60,205,1.5757395881387308,Hawkish
내부거래/NNG,16,3,19,3.477494263478579,Hawkish
사다리/NNG,74,21,95,2.297630138369775,Hawkish
강좌/NNG,22,4,26,3.5861659592122845,Hawkish
뷔페/NNG,20,1,21,13.04060348804467,Hawkish
소비/NNG;낮/VA,20,3,23,4.346867829348224,Hawkish
경과조치/NNG,65,4,69,10.595490334036295,Hawkish
스태그플레이션/NNG;우려/NNG,49,8,57,3.99368481821368,Hawkish
나오/VV,6800,3246,10046,1.3659288927711608,Hawkish
피크/NNG,89,39,128,1.4879662954307378,Hawkish
달째/NNG,129,60,189,1.401864874964802,Hawkish
신용등급/NNG;부정적/VAX,18,5,23,2.3473086278480406,Hawkish
고용시장/NNG;둔화/NNG,54,10,64,3.5209629417720607,Hawkish
구주/NNG,94,7,101,8.755833770544278,Hawkish
나와야/VV,33,8,41,2.689624469409213,Hawkish
각인/NNG,16,4,20,2.608120697608934,Hawkish
노후화/NNG,24,3,27,5.2162413952178674,Hawkish
c커머스/NNG,18,7,25,1.6766490198914574,Hawkish
수익/NNG;확대/NNG,58,8,66,4.727218764416193,Hawkish
헌신/NNG,21,7,28,1.9560905232067007,Hawkish
황금/NNG,17,6,23,1.847418827472995,Hawkish
이용금액/NNG,30,8,38,2.4451131540083755,Hawkish
성지/NNG,14,4,18,2.282105610407817,Hawkish
후속/NNG,231,114,345,1.321219037604526,Hawkish
항로/NNG,42,5,47,5.477053464978762,Hawkish
담창구/NNG,17,3,20,3.69483765494599,Hawkish
보도/NNG,646,311,957,1.3543777899158933,Hawkish
원달러/NNG;상승/NNG;압력/NNG,12,6,18,1.3040603488044669,Hawkish
인과/NNG,14,4,18,2.282105610407817,Hawkish
손실/NNG;크/VV,23,6,29,2.4994490018752287,Hawkish
입력/NNG,56,18,74,2.0285383203625043,Hawkish
실적/NNG;개선/NNG;긍정적/VAX,13,4,17,2.119098066807259,Hawkish
대하/VV,401,171,572,1.5290298241830154,Hawkish
급랭/NNG,16,3,19,3.477494263478579,Hawkish
엎친/VV,18,8,26,1.467067892405025,Hawkish
구로/NNG,25,7,32,2.328679194293691,Hawkish
경제/NNG;어렵/VA,27,13,40,1.3542165160661772,Hawkish
신상품/NNG,110,22,132,3.260150872011168,Hawkish
물가/NNG;상승/NNG;우려/NNG,51,15,66,2.2169025929675934,Hawkish
소각/NNG,173,29,202,3.8896972472960822,Hawkish
국가채무비율/NNG,15,6,21,1.6300754360055836,Hawkish
소유자/NNG,91,18,109,3.2963747705890696,Hawkish
희석/NNG,62,29,91,1.3939955452737407,Hawkish
꺼려/VV,18,4,22,2.9341357848100507,Hawkish
정무위원회/NNG,43,6,49,4.67288291654934,Hawkish
순자산/NNG;넘/VV,27,7,34,2.514973529837186,Hawkish
수요/NNG;급감/NNG,26,10,36,1.6952784534458072,Hawkish
지급여력/NNG,30,6,36,3.260150872011167,Hawkish
손익/NNG;개선/NNG,39,6,45,4.238196133614518,Hawkish
처장/NNG,29,1,30,18.908875057664773,Hawkish
유명/NNG,166,58,224,1.866155326737427,Hawkish
인증제도/NNG,17,4,21,2.7711282412094924,Hawkish
골치/NNG,14,7,21,1.3040603488044669,Hawkish
와중/NNG,128,55,183,1.517452042245198,Hawkish
메타/NNG,548,114,662,3.134320487477403,Hawkish
퇴직금/NNG,157,63,220,1.624900593351598,Hawkish
기업금융/NNG,225,96,321,1.5281957212552348,Hawkish
취임식/NNG,20,9,29,1.4489559431160743,Hawkish
미결제/NNG,25,12,37,1.3583961966713198,Hawkish
여소/NNG,114,16,130,4.645714992615914,Hawkish
렌털/NNG,37,2,39,12.06255822644132,Hawkish
의석수/NNG,20,3,23,4.346867829348224,Hawkish
동국/NNG,18,5,23,2.3473086278480406,Hawkish
장학금/NNG,15,3,18,3.260150872011167,Hawkish
합작사/NNG,15,5,20,1.9560905232067003,Hawkish
정책/NNG;개선/NNG,17,1,18,11.08451296483797,Hawkish
없애/VV,88,41,129,1.399479398716989,Hawkish
공실률/NNG,340,85,425,2.608120697608934,Hawkish
왜곡/NNG,157,30,187,3.4122912460383548,Hawkish
걸어서/VV,12,5,17,1.5648724185653602,Hawkish
결성/NNG,182,7,189,16.952784534458072,Hawkish
맞춰야/VV,45,13,58,2.2570275267769624,Hawkish
즐비/NNG,12,5,17,1.5648724185653602,Hawkish
앵커/NNG,102,37,139,1.7974885888926435,Hawkish
노릴/VV,40,13,53,2.006246690468411,Hawkish
위험/NNG;축소/NNG,30,10,40,1.9560905232067003,Hawkish
그램/NNG,18,2,20,5.868271569620101,Hawkish
딜러/NNG,127,51,178,1.6236829833153656,Hawkish
쏟아질/VV,32,11,43,1.896815052806497,Hawkish
벽체/NNG,22,2,24,7.172331918424569,Hawkish
국간/NNG,19,8,27,1.548571664205305,Hawkish
경기/NNG;모멘텀/NNG;둔화/NNG,13,6,19,1.4127320445381726,Hawkish
꼼꼼히/MAG,93,40,133,1.515970155485193,Hawkish
손보사/NNG,166,51,217,2.122294293152368,Hawkish
필드/NNG,29,5,34,3.7817750115329543,Hawkish
해약금/NNG,16,1,17,10.432482790435737,Hawkish
관리처분/NNG,17,4,21,2.7711282412094924,Hawkish
일고/NNG,13,6,19,1.4127320445381726,Hawkish
금융시장/NNG;fed/NNG;금리/NNG;인하/NNG,21,6,27,2.2821056104078177,Hawkish
공시가격/NNG,132,25,157,3.4427193208437927,Hawkish
순매수비중/NNG,14,3,17,3.042807480543756,Hawkish
경기/NNG;전망/NNG;불투명/NNG,19,3,22,4.1295244378808125,Hawkish
갱신/NNG,156,72,228,1.4127320445381726,Hawkish
꾸려/VV,27,12,39,1.467067892405025,Hawkish
경제/NNG;제재/NNG;강화/NNG,13,5,18,1.6952784534458072,Hawkish
국책/NNG,34,10,44,2.216902592967594,Hawkish
총선/NNG,1206,522,1728,1.5064145408603329,Hawkish
유학생/NNG,23,5,28,2.999338802250274,Hawkish
기소/NNG,31,8,39,2.526616925808655,Hawkish
나이/NNG,98,37,135,1.7269988403086185,Hawkish
숙박/NNG,216,101,317,1.3944407690186378,Hawkish
속출/NNG,141,45,186,2.043027879793665,Hawkish
매입비중/NNG,77,14,91,3.586165959212284,Hawkish
촉구/NNG,107,43,150,1.6224936897916042,Hawkish
유가/NNG;안정/NNG,57,12,69,3.097143328410609,Hawkish
마곡/NNG,37,8,45,3.01563955661033,Hawkish
통틀어/MAG,35,5,40,4.5642112208156345,Hawkish
갖췄/VV,96,36,132,1.738747131739289,Hawkish
출렁일/VV,28,12,40,1.521403740271878,Hawkish
대량/NNG,122,55,177,1.4463214777649542,Hawkish
심리/NNG;크/VV,13,6,19,1.4127320445381726,Hawkish
투자주/NNG,14,4,18,2.282105610407817,Hawkish
어스/NNG,29,13,42,1.454528850589598,Hawkish
검증/NNG,143,55,198,1.695278453445807,Hawkish
경기/NNG;호전/NNG,16,7,23,1.4903546843479625,Hawkish
사업비/NNG,165,67,232,1.6057459518860973,Hawkish
머뭇거리/VV,13,4,17,2.119098066807259,Hawkish
지나갑니다/VV,19,6,25,2.0647622189404062,Hawkish
주식양도/NNG,43,11,54,2.548845227208731,Hawkish
실감/NNG,15,7,22,1.3972075165762146,Hawkish
예상/NNG;웃돌/VV,177,54,231,2.1372100160962093,Hawkish
공급/NNG;강화/NNG,15,2,17,4.890226308016751,Hawkish
이연/NNG,100,37,137,1.7622437146006311,Hawkish
매출/NNG;영업이익/NNG;감소/NNG,46,2,48,14.996694011251371,Hawkish
대출/NNG;이자/NNG;부담/NNG,22,11,33,1.3040603488044669,Hawkish
집/NNG;마련/NNG;부담/NNG,12,6,18,1.3040603488044669,Hawkish
수익/NNG;확보/NNG,27,11,38,1.600437700805482,Hawkish
경쟁사/NNG,139,45,184,2.014048760931344,Hawkish
푸르/VA,46,6,52,4.998898003750457,Hawkish
구독/NNG,395,143,538,1.8010623698523232,Hawkish
지출/NNG;줄/VV,27,11,38,1.600437700805482,Hawkish
도장/NNG,16,7,23,1.4903546843479625,Hawkish
판매/NNG;성장/NNG,25,5,30,3.260150872011168,Hawkish
원원/NNG,14,5,19,1.8256844883262535,Hawkish
케이/NNG,34,14,48,1.58350185211971,Hawkish
부진/NNG;물가/NNG;상승/NNG,17,1,18,11.08451296483797,Hawkish
가치투자/NNG,35,9,44,2.53567290045313,Hawkish
연체율/NNG;낮/VA,20,8,28,1.6300754360055838,Hawkish
우수/NNG,804,272,1076,1.9273244861007195,Hawkish
꿈틀거리/VV,12,5,17,1.5648724185653602,Hawkish
그친다/VV,45,21,66,1.3972075165762148,Hawkish
소매점/NNG,39,4,43,6.3572942004217765,Hawkish
연환산/NNG,104,49,153,1.383900778323108,Hawkish
페이퍼/NNG,21,10,31,1.3692633662446905,Hawkish
통관기준/NNG,47,22,69,1.3929735544047714,Hawkish
지출/NNG;확대/NNG,22,10,32,1.4344663836849136,Hawkish
운영사/NNG,40,6,46,4.346867829348224,Hawkish
프리랜서/NNG,22,10,32,1.4344663836849136,Hawkish
달성/NNG,1364,654,2018,1.359891678722701,Hawkish
나스닥100/NNG,49,10,59,3.194947854570944,Hawkish
상방/NNG;압력/NNG,82,21,103,2.546022585761102,Hawkish
인접/NNG,120,49,169,1.5968085903728166,Hawkish
산재/NNG,44,15,59,1.912621844913218,Hawkish
지수/NNG;넘/VV,26,5,31,3.3905569068916144,Hawkish
자금중개기능/NNG,25,10,35,1.6300754360055838,Hawkish
경영계획/NNG,15,6,21,1.6300754360055836,Hawkish
손실률/NNG,44,9,53,3.187703074855364,Hawkish
파르테논/NNG,17,1,18,11.08451296483797,Hawkish
떠날/VV,14,7,21,1.3040603488044669,Hawkish
형편/NNG,27,10,37,1.7604814708860304,Hawkish
산업협회/NNG,51,20,71,1.6626769447256953,Hawkish
상법/NNG,34,16,50,1.3855641206047462,Hawkish
왼쪽/NNG,34,14,48,1.58350185211971,Hawkish
유예/NNG,413,123,536,2.189337089659532,Hawkish
매도차익/NNG,19,4,23,3.0971433284106094,Hawkish
승부/NNG,28,13,41,1.4043726833278876,Hawkish
우선/NNG,66,30,96,1.4344663836849136,Hawkish
업황/NNG;호조/NNG,26,6,32,2.825464089076345,Hawkish
조합장/NNG,26,12,38,1.4127320445381726,Hawkish
기고문/NNG,18,9,27,1.3040603488044669,Hawkish
피벗/NNG,388,185,573,1.3675011225300897,Hawkish
혼선/NNG,32,15,47,1.3909977053914315,Hawkish
원화/NNG;약세/NNG;부담/NNG,19,2,21,6.194286656821219,Hawkish
달래/VV,17,2,19,5.542256482418985,Hawkish
방문객/NNG,40,10,50,2.608120697608934,Hawkish
영업이익/NNG;증가/NNG,128,43,171,1.9409270307787416,Hawkish
우려/NNG;양호/NNG,25,3,28,5.433584786685279,Hawkish
추종/NNG,368,143,511,1.6779517774826709,Hawkish
거시/NNG;안정/NNG,12,6,18,1.3040603488044669,Hawkish
거뒀/VV,190,81,271,1.529453495511412,Hawkish
수요자/NNG;부담/NNG,26,6,32,2.825464089076345,Hawkish
고배/NNG,35,12,47,1.901754675339848,Hawkish
민간기업/NNG,70,34,104,1.342415064945775,Hawkish
시리/NNG,24,7,31,2.2355320265219434,Hawkish
초과이익/NNG,21,9,30,1.5214037402718783,Hawkish
유니폼/NNG,13,5,18,1.6952784534458072,Hawkish
농업인/NNG,37,1,38,24.12511645288264,Hawkish
합격/NNG,17,8,25,1.3855641206047462,Hawkish
부실시공/NNG,19,3,22,4.1295244378808125,Hawkish
소득세/NNG,348,174,522,1.304060348804467,Hawkish
건대/NNG,54,13,67,2.7084330321323544,Hawkish
불합격/NNG,17,1,18,11.08451296483797,Hawkish
시공자/NNG,18,1,19,11.736543139240204,Hawkish
부동산/NNG;상승/NNG,32,14,46,1.4903546843479625,Hawkish
금리/NNG;물가/NNG;상승/NNG,18,4,22,2.9341357848100507,Hawkish
인포/NNG,36,13,49,1.8056220214215697,Hawkish
유례없/VA,33,12,45,1.793082979606142,Hawkish
장보/NNG,15,5,20,1.9560905232067003,Hawkish
무화/NNG,32,9,41,2.318329508985719,Hawkish
칼라/NNG,19,1,20,12.388573313642436,Hawkish
근로자/NNG,452,200,652,1.4735881941490476,Hawkish
추천서/NNG,18,8,26,1.467067892405025,Hawkish
막상/MAG,38,13,51,1.9059343559449904,Hawkish
이익/NNG;성장/NNG,53,12,65,2.879799936943198,Hawkish
소득/NNG;늘/VV,31,4,35,5.05323385161731,Hawkish
양파/NNG,18,2,20,5.868271569620101,Hawkish
흑자전환/NNG;성공/NNG,76,16,92,3.0971433284106094,Hawkish
움츠러들/VV,15,4,19,2.4451131540083755,Hawkish
소비자/NNG;물가/NNG;상승률/NNG;오르/VV,16,2,18,5.216241395217868,Hawkish
대인/NNG,31,11,42,1.8375395824062943,Hawkish
세운/VV,61,16,77,2.485865039908516,Hawkish
무사히/MAG,12,5,17,1.5648724185653602,Hawkish
앞섰/VV,34,10,44,2.216902592967594,Hawkish
fed/NNG;금리/NNG;인하/NNG;늦/VV,45,18,63,1.6300754360055838,Hawkish
고수익/NNG,100,42,142,1.552452796195794,Hawkish
효율성/NNG,164,73,237,1.4648349123557023,Hawkish
에버/NNG,27,12,39,1.467067892405025,Hawkish
재개발조합/NNG,14,7,21,1.3040603488044669,Hawkish
구매력/NNG;증가/NNG,16,5,21,2.0864965580871475,Hawkish
도서관/NNG,75,18,93,2.7167923933426392,Hawkish
하한가/NNG,44,22,66,1.3040603488044669,Hawkish
일으켜/VV,17,8,25,1.3855641206047462,Hawkish
이자이익/NNG;증가/NNG,43,10,53,2.8037297499296043,Hawkish
나눴/VV,21,10,31,1.3692633662446905,Hawkish
멈추/VV,256,125,381,1.3353577971757742,Hawkish
액티브/NNG,952,444,1396,1.398046680249834,Hawkish
견조/NNG;성장/NNG,55,27,82,1.3282096145230682,Hawkish
보험부채/NNG,25,11,36,1.481886760005076,Hawkish
부동산/NNG;경기/NNG;위축/NNG,35,5,40,4.5642112208156345,Hawkish
기대수익률/NNG;높/VA,17,5,22,2.216902592967594,Hawkish
주행/NNG,60,18,78,2.1734339146741117,Hawkish
무료/NNG,285,126,411,1.4748301563860045,Hawkish
사회간접자본/NNG,48,18,66,1.738747131739289,Hawkish
매칭/NNG,146,61,207,1.5605968108643622,Hawkish
신문/NNG,269,106,375,1.6546803482471777,Hawkish
피해야/VV,14,5,19,1.8256844883262535,Hawkish
니즈/NNG,141,65,206,1.4144039167802296,Hawkish
미/NNG;fed/NNG;매파/NNG,20,2,22,6.520301744022335,Hawkish
어업/NNG,92,20,112,2.999338802250274,Hawkish
송도/NNG,20,8,28,1.6300754360055838,Hawkish
하락/NNG;지지/NNG,25,11,36,1.481886760005076,Hawkish
무역/NNG;정책/NNG;불확실성/NNG,15,2,17,4.890226308016751,Hawkish
바우처/NNG,25,8,33,2.03759429500698,Hawkish
제미/NNG,26,2,28,8.476392267229036,Hawkish
상승률/NNG;둔화/NNG,44,11,55,2.6081206976089337,Hawkish
전수조사/NNG,28,12,40,1.521403740271878,Hawkish
국채/NNG;금리/NNG;주가/NNG;하락/NNG,21,5,26,2.738526732489381,Hawkish
차용/NNG,17,3,20,3.69483765494599,Hawkish
높/VA;경기/NNG;확장/NNG,14,3,17,3.042807480543756,Hawkish
수요자/NNG;관심/NNG;높/VA,22,3,25,4.7815546122830455,Hawkish
동향점검회의/NNG,18,1,19,11.736543139240204,Hawkish
탄생/NNG,100,29,129,2.24837991173184,Hawkish
자본지출/NNG,116,46,162,1.644250005014328,Hawkish
거실/NNG,37,2,39,12.06255822644132,Hawkish
이익/NNG;개선/NNG,64,11,75,3.793630105612995,Hawkish
준하/VV,21,10,31,1.3692633662446905,Hawkish
매각계획/NNG,37,3,40,8.041705484294214,Hawkish
주택도시기금/NNG,282,65,347,2.828807833560459,Hawkish
공공분양/NNG,91,10,101,5.933474587060325,Hawkish
전자장비/NNG,14,7,21,1.3040603488044669,Hawkish
단과/NNG,35,12,47,1.901754675339848,Hawkish
오랜만/NNG,43,16,59,1.7523310937060026,Hawkish
가격/NNG;국제/NNG;유가/NNG;상승/NNG,19,5,24,2.4777146627284874,Hawkish
기업구조조정촉진법/NNG,17,5,22,2.216902592967594,Hawkish
가공/NNG,79,35,114,1.4717252507936127,Hawkish
후불제/NNG,13,6,19,1.4127320445381726,Hawkish
순수출/NNG;증가/NNG,14,3,17,3.042807480543756,Hawkish
건전성/NNG;저하/NNG,17,5,22,2.216902592967594,Hawkish
주민/NNG,256,74,330,2.255671954688808,Hawkish
타입/NNG,219,50,269,2.8558921638817827,Hawkish
쌓여/VV,61,29,90,1.3715117461564224,Hawkish
통화/NNG;급락/NNG,15,3,18,3.260150872011167,Hawkish
창업주/NNG,17,5,22,2.216902592967594,Hawkish
다급/NNG,15,3,18,3.260150872011167,Hawkish
구매력/NNG;개선/NNG,24,4,28,3.912181046413401,Hawkish
홍콩h지수/NNG,385,90,475,2.789240190498443,Hawkish
조달시장/NNG,19,7,26,1.7697961876632051,Hawkish
슈퍼사이클/NNG,20,7,27,1.8629433554349528,Hawkish
판매가격/NNG;늘/VV,45,5,50,5.868271569620102,Hawkish
인도분/NNG,133,61,194,1.4216395605819188,Hawkish
올라타/VV,13,5,18,1.6952784534458072,Hawkish
플레이스/NNG,53,12,65,2.879799936943198,Hawkish
늦/VA;금리/NNG;인하/NNG,15,5,20,1.9560905232067003,Hawkish
제법/MAG,24,11,35,1.4226112896048728,Hawkish
고환/NNG,540,241,781,1.4609804737643408,Hawkish
공장/NNG,598,263,861,1.4825629060552683,Hawkish
성장/NNG;전망/NNG;상향/NNG,16,5,21,2.0864965580871475,Hawkish
기온/NNG,154,33,187,3.042807480543756,Hawkish
거시변수/NNG,24,7,31,2.2355320265219434,Hawkish
개선/NNG;유동성/NNG;확보/NNG,18,1,19,11.736543139240204,Hawkish
내몰렸/VV,16,5,21,2.0864965580871475,Hawkish
원달러/NNG;하락/NNG,53,25,78,1.3823039697327348,Hawkish
케인스/NNG,20,2,22,6.520301744022335,Hawkish
교통망/NNG,66,18,84,2.3907773061415227,Hawkish
일민/NNG,29,4,33,4.727218764416193,Hawkish
참여기업/NNG,39,17,56,1.4958339295110064,Hawkish
배우/VV,26,11,37,1.5411622304052792,Hawkish
재검토/NNG,52,19,71,1.784503635206113,Hawkish
지주/NNG,285,112,397,1.659183925934255,Hawkish
무너/VV,233,77,310,1.9730263718924728,Hawkish
면허/NNG,30,10,40,1.9560905232067003,Hawkish
발판/NNG,59,21,80,1.831894299511037,Hawkish
바꿔야/VV,41,10,51,2.673323715049157,Hawkish
수입/NNG;줄/VV,44,20,64,1.4344663836849136,Hawkish
정정/NNG,23,9,32,1.6662993345834856,Hawkish
온스/NNG,160,72,232,1.4489559431160743,Hawkish
이자비용/NNG;부담/NNG,25,11,36,1.481886760005076,Hawkish
특유/NNG,18,5,23,2.3473086278480406,Hawkish
설비/NNG;투자/NNG;증가/NNG,40,7,47,3.7258867108699056,Hawkish
스테이지/NNG,18,9,27,1.3040603488044669,Hawkish
우려/NNG;크/VV,219,90,309,1.5866067577121017,Hawkish
배상안/NNG,17,2,19,5.542256482418985,Hawkish
하락/NNG;방어/NNG,18,6,24,1.9560905232067003,Hawkish
재정/NNG;악화/NNG,23,10,33,1.499669401125137,Hawkish
물가/NNG;상승/NNG;압력/NNG,63,24,87,1.711579207805863,Hawkish
목격/NNG,24,11,35,1.4226112896048728,Hawkish
행장/NNG,83,40,123,1.3529626118846343,Hawkish
방증/NNG,62,26,88,1.5548411851130184,Hawkish
퇴근/NNG,22,10,32,1.4344663836849136,Hawkish
통화정책/NNG;경기/NNG;개선/NNG,20,1,21,13.04060348804467,Hawkish
산업/NNG;확대/NNG,26,7,33,2.4218263620654388,Hawkish
동선/NNG,24,3,27,5.2162413952178674,Hawkish
국적/NNG,160,26,186,4.012493380936822,Hawkish
수납공간/NNG,17,5,22,2.216902592967594,Hawkish
힐링/NNG,23,4,27,3.749173502812843,Hawkish
진행/NNG,4361,2041,6402,1.393191372154895,Hawkish
우선시/NNG,36,12,48,1.9560905232067003,Hawkish
마크/NNG,77,25,102,2.008252937158879,Hawkish
다질/VV,14,5,19,1.8256844883262535,Hawkish
인플레이션/NNG;고금리/NNG,24,6,30,2.6081206976089337,Hawkish
고생/NNG,18,9,27,1.3040603488044669,Hawkish
전문지/NNG,12,5,17,1.5648724185653602,Hawkish
수익성/NNG;강화/NNG,16,7,23,1.4903546843479625,Hawkish
떨치/VV,23,4,27,3.749173502812843,Hawkish
범야/NNG,67,4,71,10.921505421237413,Hawkish
손익분기/NNG,14,4,18,2.282105610407817,Hawkish
용기/NNG,20,5,25,2.608120697608934,Hawkish
상속증여세/NNG,30,5,35,3.912181046413401,Hawkish
먹거리/NNG,142,63,205,1.4696553137320183,Hawkish
3고시대/NNG,15,7,22,1.3972075165762146,Hawkish
원격/NNG,19,5,24,2.4777146627284874,Hawkish
가격/NNG;낮/VV,35,12,47,1.901754675339848,Hawkish
부유층/NNG,33,8,41,2.689624469409213,Hawkish
지상/NNG,276,108,384,1.6662993345834851,Hawkish
아파트중도금대출/NNG,33,6,39,3.586165959212284,Hawkish
방대/NNG,31,9,40,2.2458817118299157,Hawkish
셀인/NNG,39,8,47,3.1786471002108883,Hawkish
마이/MAG,53,15,68,2.303839949554558,Hawkish
인원/NNG,176,78,254,1.4712475730101675,Hawkish
월급봉투/NNG,24,1,25,15.648724185653604,Hawkish
주역/NNG,23,5,28,2.999338802250274,Hawkish
제형/NNG,16,2,18,5.216241395217868,Hawkish
호반/NNG,124,9,133,8.983526847319661,Hawkish
매출/NNG;오르/VV,65,16,81,2.648872583509074,Hawkish
투자/NNG;지연/NNG,17,2,19,5.542256482418985,Hawkish
안성/NNG,35,5,40,4.5642112208156345,Hawkish
원룸/NNG,39,15,54,1.695278453445807,Hawkish
하늘/NNG,66,16,82,2.689624469409213,Hawkish
아낄/VV,33,11,44,1.9560905232067003,Hawkish
브릿지론/NNG,260,90,350,1.8836427260508968,Hawkish
시간외거래/NNG,122,36,158,2.2096578132520137,Hawkish
따질/VV,18,2,20,5.868271569620101,Hawkish
부동산펀드/NNG,86,37,123,1.5155295945565428,Hawkish
생생/NNG,22,9,31,1.5938515374276818,Hawkish
카드업계/NNG,122,34,156,2.3396376846197797,Hawkish
수출/NNG;확대/NNG,50,18,68,1.811194928895093,Hawkish
특별지원/NNG,25,11,36,1.481886760005076,Hawkish
환전/NNG,262,100,362,1.7083190569338518,Hawkish
감정가/NNG,223,59,282,2.4644530320626794,Hawkish
로카/NNG,27,3,30,5.868271569620101,Hawkish
수가/NNG,17,5,22,2.216902592967594,Hawkish
의식/NNG,122,54,176,1.4731052088346757,Hawkish
지지선/NNG,65,15,80,2.825464089076345,Hawkish
산단/VV,24,4,28,3.912181046413401,Hawkish
꾸리/VV,18,6,24,1.9560905232067003,Hawkish
목표액/NNG,60,28,88,1.3972075165762146,Hawkish
정지/NNG,122,58,180,1.3715117461564224,Hawkish
새로이/MAG,13,6,19,1.4127320445381726,Hawkish
손해배상/NNG,35,3,38,7.607018701359391,Hawkish
지정학/NNG,1785,865,2650,1.345518914806921,Hawkish
유가/NNG;상승/NNG,141,55,196,1.6715682652857258,Hawkish
보호/NNG,330,143,473,1.504685017851308,Hawkish
박모/NNG,13,6,19,1.4127320445381726,Hawkish
비용/NNG;상승/NNG,108,20,128,3.5209629417720607,Hawkish
아이콘/NNG,16,6,22,1.7387471317392895,Hawkish
재비/NNG,18,7,25,1.6766490198914574,Hawkish
자금/NNG;안정/NNG,13,4,17,2.119098066807259,Hawkish
안정/NNG;수익/NNG;확보/NNG,28,5,33,3.651368976652508,Hawkish
소유주/NNG,75,11,86,4.445660280015228,Hawkish
장기물/NNG;강세/NNG,17,8,25,1.3855641206047462,Hawkish
출렁/MAG,20,7,27,1.8629433554349528,Hawkish
일회성비용/NNG,160,6,166,17.387471317392894,Hawkish
최대/NNG;늘/VV,20,10,30,1.304060348804467,Hawkish
회원/NNG,222,87,309,1.6638011346815615,Hawkish
불어났/VV,95,47,142,1.3179333312385568,Hawkish
다다른/VV,39,9,48,2.825464089076345,Hawkish
국채선물시장/NNG,161,55,216,1.908670146886538,Hawkish
순이익/NNG;넘/VV,16,7,23,1.4903546843479625,Hawkish
영업이익/NNG;감소/NNG,112,25,137,2.921095181322006,Hawkish
간다면/VV,33,11,44,1.9560905232067003,Hawkish
엔지니어/NNG,13,6,19,1.4127320445381726,Hawkish
트레이더/NNG,106,40,146,1.7278799621659189,Hawkish
행복/NNG,145,59,204,1.6024470387851502,Hawkish
최저생계비/NNG,18,3,21,3.912181046413401,Hawkish
치러진/VV,27,13,40,1.3542165160661772,Hawkish
생산자/NNG;물가/NNG;상승/NNG,24,4,28,3.912181046413401,Hawkish
들여다보/VV,53,22,75,1.5707999656053806,Hawkish
금리/NNG;인하/NNG;어렵/VA,75,36,111,1.3583961966713196,Hawkish
근간인/NNG,18,5,23,2.3473086278480406,Hawkish
사과/NNG,235,29,264,5.283692792569823,Hawkish
펀드평가사/NNG,41,15,56,1.7822158100327714,Hawkish
연금보험/NNG,47,15,62,2.043027879793665,Hawkish
단일시장/NNG,18,5,23,2.3473086278480406,Hawkish
참여율/NNG,60,13,73,3.009370035702616,Hawkish
복도/NNG,21,6,27,2.2821056104078177,Hawkish
기대수익률/NNG,87,40,127,1.418165629324858,Hawkish
유가/NNG,3895,1946,5841,1.305065534068191,Hawkish
불황/NNG,354,152,506,1.5185439588052017,Hawkish
채권분석/NNG,62,16,78,2.526616925808655,Hawkish
발제/NNG,41,18,59,1.485179841693976,Hawkish
진통/NNG,24,11,35,1.4226112896048728,Hawkish
인센티브/NNG,464,155,619,1.951883876920235,Hawkish
맞춰서/VV,25,12,37,1.3583961966713198,Hawkish
명품/NNG,143,27,170,3.4533449977599773,Hawkish
모른다/VV,58,27,85,1.400657411678872,Hawkish
소셜미디어/NNG,34,10,44,2.216902592967594,Hawkish
농산물/NNG;가격/NNG;높/VA,17,3,20,3.69483765494599,Hawkish
주도주/NNG,103,38,141,1.7673449464060542,Hawkish
제품/NNG;비중/NNG;확대/NNG,16,1,17,10.432482790435737,Hawkish
경매/NNG,948,317,1265,1.9499198906413795,Hawkish
기대/NNG;확대/NNG,14,5,19,1.8256844883262535,Hawkish
당분간/MAG;완화/NNG,37,6,43,4.020852742147107,Hawkish
하나하나/MAG,13,5,18,1.6952784534458072,Hawkish
일문일답/NNG,34,13,47,1.7053096868981492,Hawkish
소비/NNG;여력/NNG;늘/VV,17,1,18,11.08451296483797,Hawkish
거래금액/NNG,146,61,207,1.5605968108643622,Hawkish
높/VA;대출/NNG;금리/NNG;부담/NNG,30,13,43,1.504685017851308,Hawkish
작금/NNG,13,6,19,1.4127320445381726,Hawkish
격려/NNG,12,6,18,1.3040603488044669,Hawkish
보증보험/NNG,25,11,36,1.481886760005076,Hawkish
굵직/NNG,52,13,65,2.608120697608934,Hawkish
고용/NNG;고용자수/NNG;증가/NNG,14,7,21,1.3040603488044669,Hawkish
배상비/NNG,127,4,131,20.701958037270916,Hawkish
합류/NNG,89,36,125,1.6119634867166326,Hawkish
취재/NNG,130,62,192,1.3671600431014574,Hawkish
정비/NNG,642,246,888,1.7016397234399754,Hawkish
용인/NNG,102,36,138,1.8474188274729948,Hawkish
상환/NNG;부담/NNG;경감/NNG,17,4,21,2.7711282412094924,Hawkish
접점/NNG,39,15,54,1.695278453445807,Hawkish
성장/NNG;견조/NNG,15,4,19,2.4451131540083755,Hawkish
입소문/NNG,55,15,70,2.3907773061415227,Hawkish
지산/NNG,25,1,26,16.300754360055837,Hawkish
제의/NNG,15,6,21,1.6300754360055836,Hawkish
통화정책방향회의/NNG,149,36,185,2.6986804440536885,Hawkish
만만/NNG,92,35,127,1.7139078870001567,Hawkish
위험/NNG;상승/NNG,22,7,29,2.049237690978448,Hawkish
일렉트론/NNG,25,2,27,8.150377180027919,Hawkish
압승/NNG,142,19,161,4.873067619216693,Hawkish
친환경선박/NNG,90,12,102,4.890226308016752,Hawkish
글로벌/NNG;통화정책/NNG;긴축/NNG,26,3,29,5.65092817815269,Hawkish
홀딩스/NNG,536,235,771,1.487183716934456,Hawkish
돈다/VV,20,7,27,1.8629433554349528,Hawkish
신통/NNG,57,9,66,4.129524437880812,Hawkish
파우/NNG,21,2,23,6.846316831223453,Hawkish
풀이/NNG,1142,537,1679,1.386626553384266,Hawkish
물음표/NNG,25,4,29,4.075188590013959,Hawkish
인지/NNG,127,56,183,1.4787112883764937,Hawkish
fed/NNG;금리/NNG;인하/NNG;기대/NNG;크/VV,39,11,50,2.3117433456079186,Hawkish
액화천연가스/NNG,39,10,49,2.542917680168711,Hawkish
실개입/NNG,45,8,53,3.667669731012564,Hawkish
유지율/NNG,260,19,279,8.922518176030565,Hawkish
라이트/NNG,19,3,22,4.1295244378808125,Hawkish
경제/NNG;모멘텀/NNG,16,2,18,5.216241395217868,Hawkish
물가/NNG;상승/NNG;압력/NNG;크/VV,32,7,39,2.9807093686959245,Hawkish
상인/NNG,239,57,296,2.733951082142698,Hawkish
보료/NNG,53,9,62,3.839733249257597,Hawkish
해지/NNG;위험/NNG,17,5,22,2.216902592967594,Hawkish
프라이버시/NNG,14,6,20,1.521403740271878,Hawkish
성장/NNG;약화/NNG,28,12,40,1.521403740271878,Hawkish
상가/NNG,900,189,1089,3.1049055923915883,Hawkish
개정안/NNG,342,151,493,1.4767835738116812,Hawkish
사기/NNG,894,266,1160,2.1914096838932213,Hawkish
장교/NNG,30,6,36,3.260150872011167,Hawkish
신생/NNG,15,5,20,1.9560905232067003,Hawkish
의뢰/NNG,48,21,69,1.490354684347962,Hawkish
공급/NNG;축소/NNG,21,6,27,2.2821056104078177,Hawkish
하방/NNG;위험/NNG,28,13,41,1.4043726833278876,Hawkish
워낙/MAG,147,59,206,1.6245497565614972,Hawkish
이자이익/NNG;늘/VV,26,6,32,2.825464089076345,Hawkish
테마주/NNG,75,24,99,2.03759429500698,Hawkish
수익성/NNG;떨어/VV,12,6,18,1.3040603488044669,Hawkish
탄력세율/NNG,21,5,26,2.738526732489381,Hawkish
감자/NNG,95,18,113,3.4412703649006766,Hawkish
후보지/NNG,22,4,26,3.5861659592122845,Hawkish
하락/NNG;물가/NNG;안정/NNG,25,2,27,8.150377180027919,Hawkish
해약환급금/NNG,21,6,27,2.2821056104078177,Hawkish
불리/VV,362,177,539,1.3335306391729296,Hawkish
달한다고/VV,19,6,25,2.0647622189404062,Hawkish
자산/NNG;가격/NNG;오르/VV,17,6,23,1.847418827472995,Hawkish
악화/NNG;실적/NNG;부진/NNG,16,2,18,5.216241395217868,Hawkish
바라봤/VV,13,5,18,1.6952784534458072,Hawkish
유동부채/NNG,19,6,25,2.0647622189404062,Hawkish
구인/NNG,80,22,102,2.371018816008122,Hawkish
법령/NNG,80,34,114,1.5341886456523142,Hawkish
채소/NNG,98,15,113,4.259930472761258,Hawkish
도급/NNG,31,15,46,1.3475290270979492,Hawkish
전기요금/NNG;인상/NNG,17,6,23,1.847418827472995,Hawkish
공시지가/NNG,29,7,36,2.701267865380682,Hawkish
pbr/NNG,545,221,766,1.607947715154829,Hawkish
세탁/NNG,22,7,29,2.049237690978448,Hawkish
디커플링/NNG,56,17,73,2.14786410391324,Hawkish
자본주의/NNG,29,14,43,1.350633932690341,Hawkish
열기/NNG,137,51,188,1.7515320371197254,Hawkish
세입/NNG,86,39,125,1.4378101281690276,Hawkish
선보여/VV,52,5,57,6.781113813783229,Hawkish
사몰/NNG,19,1,20,12.388573313642436,Hawkish
불어넣/VV,85,35,120,1.5835018521197102,Hawkish
한옥/NNG,16,2,18,5.216241395217868,Hawkish
상호부금/NNG,43,17,60,1.6492527940762378,Hawkish
금리/NNG;인하/NNG;아니/VCN;금리/NNG;인상/NNG,16,2,18,5.216241395217868,Hawkish
제품/NNG;안정/NNG,17,2,19,5.542256482418985,Hawkish
퍼티/NNG,20,1,21,13.04060348804467,Hawkish
시공권/NNG,19,3,22,4.1295244378808125,Hawkish
외식/NNG,217,77,294,1.837539582406294,Hawkish
뒤늦/VA,47,23,70,1.3324094868219554,Hawkish
중개사/NNG,15,7,22,1.3972075165762146,Hawkish
미지수/NNG,90,36,126,1.6300754360055838,Hawkish
한영/NNG,22,3,25,4.7815546122830455,Hawkish
지점장/NNG,46,11,57,2.72667163840934,Hawkish
가격/NNG;상승/NNG,364,171,535,1.3879472718269763,Hawkish
재정상황/NNG,36,17,53,1.3807697810870827,Hawkish
금리/NNG;인하/NNG;기대/NNG;확대/NNG,19,5,24,2.4777146627284874,Hawkish
인플레이션/NNG;가속/NNG,27,8,35,2.200601838607538,Hawkish
닷컴/NNG;거품/NNG,12,6,18,1.3040603488044669,Hawkish
예상/NNG;둔화/NNG,35,9,44,2.53567290045313,Hawkish
스타일/NNG,40,18,58,1.4489559431160743,Hawkish
취미/NNG,34,16,50,1.3855641206047462,Hawkish
예기/NNG,31,14,45,1.4437811004620884,Hawkish
환율조작국/NNG,23,8,31,1.8745867514064212,Hawkish
경영/NNG;불확실성/NNG,34,8,42,2.7711282412094924,Hawkish
경기/NNG;상승/NNG,96,15,111,4.172993116174294,Hawkish
제조기업/NNG,82,16,98,3.341654643811447,Hawkish
몰아주/VV,30,6,36,3.260150872011167,Hawkish
국고채/NNG;통안채/NNG;스프레드/NNG;축소/NNG,30,5,35,3.912181046413401,Hawkish
물적분할/NNG,20,3,23,4.346867829348224,Hawkish
신용위험평가/NNG,34,8,42,2.7711282412094924,Hawkish
실사/NNG,187,77,264,1.5835018521197095,Hawkish
배당/NNG;성장/NNG,14,3,17,3.042807480543756,Hawkish
몸값/NNG,86,36,122,1.55762763884978,Hawkish
감가상각비/NNG,23,11,34,1.36333581920467,Hawkish
기우/NNG,29,6,35,3.151479176277462,Hawkish
제지/NNG,43,17,60,1.6492527940762378,Hawkish
첨단/NNG,321,142,463,1.4739555350923728,Hawkish
의제/NNG,61,8,69,4.971730079817031,Hawkish
예우/NNG,22,1,23,14.344663836849138,Hawkish
상정/NNG,68,28,96,1.58350185211971,Hawkish
유가/NNG;전망/NNG;하향/NNG,23,2,25,7.498347005625686,Hawkish
그리/VV,175,75,250,1.5214037402718783,Hawkish
최대/NNG;확대/NNG,22,4,26,3.5861659592122845,Hawkish
공급업체/NNG,22,11,33,1.3040603488044669,Hawkish
저온/NNG,29,9,38,2.100986117518308,Hawkish
최대/NNG;상승/NNG,44,12,56,2.3907773061415227,Hawkish
복수/NNG,78,28,106,1.816369771549079,Hawkish
세워야/VV,25,9,34,1.811194928895093,Hawkish
내부/NNG,295,145,440,1.3265441479217854,Hawkish
아크/NNG,119,56,175,1.3855641206047462,Hawkish
회부/NNG,29,6,35,3.151479176277462,Hawkish
임대료/NNG,431,147,578,1.9117347290296776,Hawkish
영수/NNG,22,8,30,1.7930829796061425,Hawkish
비교우위/NNG,12,5,17,1.5648724185653602,Hawkish
시장가치/NNG,17,7,24,1.58350185211971,Hawkish
거래액/NNG,154,37,191,2.713855320484972,Hawkish
저축액/NNG,20,7,27,1.8629433554349528,Hawkish
수지/NNG;흑자/NNG,14,7,21,1.3040603488044669,Hawkish
부채비율/NNG;하락/NNG,14,5,19,1.8256844883262535,Hawkish
금리/NNG;불확실성/NNG,56,24,80,1.521403740271878,Hawkish
예정이율/NNG,24,2,26,7.824362092826802,Hawkish
차질/NNG,373,172,545,1.413995668907169,Hawkish
양도소득/NNG,14,4,18,2.282105610407817,Hawkish
한찬/NNG,14,4,18,2.282105610407817,Hawkish
순자본비율/NNG,13,4,17,2.119098066807259,Hawkish
경제/NNG;둔화/NNG,40,20,60,1.304060348804467,Hawkish
성장동력/NNG;확보/NNG,26,7,33,2.4218263620654388,Hawkish
공공기여/NNG,32,7,39,2.9807093686959245,Hawkish
사들여/VV,45,22,67,1.333698084004569,Hawkish
로그인/NNG,15,6,21,1.6300754360055836,Hawkish
외화환산손실/NNG,17,2,19,5.542256482418985,Hawkish
준칙/NNG,82,13,95,4.112805715460242,Hawkish
희망퇴직/NNG,60,15,75,2.6081206976089337,Hawkish
가상/NNG,714,273,987,1.7053096868981492,Hawkish
이익잉여금/NNG,28,11,39,1.6597131712056852,Hawkish
예술/NNG,60,21,81,1.8629433554349528,Hawkish
비용/NNG;낮/VV,17,6,23,1.847418827472995,Hawkish
톤세제/NNG,28,1,29,18.256844883262534,Hawkish
나쁘/VV,15,4,19,2.4451131540083755,Hawkish
헤즈볼라/NNG,25,1,26,16.300754360055837,Hawkish
판매가격/NNG;증가/NNG,26,3,29,5.65092817815269,Hawkish
댓글/NNG,18,5,23,2.3473086278480406,Hawkish
주석/NNG,56,17,73,2.14786410391324,Hawkish
페드워치/NNG,425,183,608,1.514277727436881,Hawkish
오류/NNG,52,23,75,1.4741551769093977,Hawkish
기대/NNG;넘/VV,40,18,58,1.4489559431160743,Hawkish
팔리/VV,103,38,141,1.7673449464060542,Hawkish
녹색금융/NNG,25,9,34,1.811194928895093,Hawkish
희망자/NNG,28,8,36,2.282105610407817,Hawkish
철강/NNG,529,253,782,1.36333581920467,Hawkish
입시/NNG,36,16,52,1.467067892405025,Hawkish
곤두박질쳤/VV,14,7,21,1.3040603488044669,Hawkish
강하/VA;성장/NNG,18,9,27,1.3040603488044669,Hawkish
중국시장/NNG,68,31,99,1.4302597373984476,Hawkish
신분증/NNG,28,11,39,1.6597131712056852,Hawkish
장만/NNG,14,4,18,2.282105610407817,Hawkish
소장/NNG,129,29,158,2.9004100861340736,Hawkish
그룹/NNG,1705,827,2532,1.344270190273045,Hawkish
앞날/NNG,15,2,17,4.890226308016751,Hawkish
찾아왔/VV,16,5,21,2.0864965580871475,Hawkish
엄선/NNG,20,7,27,1.8629433554349528,Hawkish
사외이사/NNG,18,4,22,2.9341357848100507,Hawkish
생산유발효과/NNG,26,2,28,8.476392267229036,Hawkish
하락/NNG;줄/VV,40,10,50,2.608120697608934,Hawkish
일부러/MAG,13,4,17,2.119098066807259,Hawkish
과매도/NNG,45,15,60,1.9560905232067003,Hawkish
나스/VV,60,6,66,6.520301744022334,Hawkish
자금부족/NNG,28,5,33,3.651368976652508,Hawkish
사로/NNG,14,4,18,2.282105610407817,Hawkish
맴돌/VV,22,10,32,1.4344663836849136,Hawkish
내수/NNG;살/VV,21,9,30,1.5214037402718783,Hawkish
부진/NNG;감소/NNG,19,4,23,3.0971433284106094,Hawkish
호스/NNG,24,3,27,5.2162413952178674,Hawkish
아우르/VV,76,17,93,2.914958426739397,Hawkish
한도규제/NNG,17,7,24,1.58350185211971,Hawkish
업계/NNG,3094,1391,4485,1.4503101075488931,Hawkish
지혜/NNG,23,10,33,1.499669401125137,Hawkish
채권단/NNG,202,72,274,1.829306878184044,Hawkish
점프/NNG,40,5,45,5.216241395217868,Hawkish
출점/NNG,27,6,33,2.9341357848100507,Hawkish
수익성/NNG;약화/NNG,23,6,29,2.4994490018752287,Hawkish
전세/NNG;수요/NNG;증가/NNG,17,3,20,3.69483765494599,Hawkish
후퇴/NNG,850,407,1257,1.3617337794641242,Hawkish
타이트한/VA,12,6,18,1.3040603488044669,Hawkish
관측/NNG,896,394,1290,1.4827894321431505,Hawkish
경보/NNG,15,6,21,1.6300754360055836,Hawkish
방치/NNG,55,19,74,1.8874557680064656,Hawkish
나옵니다/VV,197,92,289,1.3961950473613045,Hawkish
금융시장/NNG;변동성/NNG;크/VV,14,5,19,1.8256844883262535,Hawkish
그야말로/MAG,37,12,49,2.010426371073553,Hawkish
톡톡히/MAG,48,11,59,2.8452225792097456,Hawkish
채울/VV,24,6,30,2.6081206976089337,Hawkish
건설/NNG;투자/NNG;감소/NNG,24,9,33,1.738747131739289,Hawkish
금리/NNG;부담/NNG,75,37,112,1.3216827859504734,Hawkish
따라잡/VV,56,16,72,2.282105610407817,Hawkish
상각/NNG,213,95,308,1.4619202857650078,Hawkish
전략적제휴/NNG,17,4,21,2.7711282412094924,Hawkish
거듭/MAG,319,138,457,1.507229171263134,Hawkish
불확실성/NNG;크/VV,144,61,205,1.5392187723593709,Hawkish
골머리/NNG,16,5,21,2.0864965580871475,Hawkish
내수/NNG;회복/NNG,147,29,176,3.3051184702458047,Hawkish
네이처/NNG,19,1,20,12.388573313642436,Hawkish
수입업체/NNG,20,5,25,2.608120697608934,Hawkish
오인/NNG,82,6,88,8.911079050163858,Hawkish
재건축시장/NNG,18,7,25,1.6766490198914574,Hawkish
끊이/VV,37,18,55,1.3402842473823688,Hawkish
간접투자/NNG,32,12,44,1.7387471317392895,Hawkish
세컨더리펀드/NNG,64,4,68,10.432482790435737,Hawkish
침투/NNG,23,5,28,2.999338802250274,Hawkish
자양/NNG,43,2,45,14.01864874964802,Hawkish
통학/NNG,27,8,35,2.200601838607538,Hawkish
통화/NNG;긴축/NNG;완화/NNG,16,2,18,5.216241395217868,Hawkish
모양새/NNG,323,127,450,1.6583129632434757,Hawkish
허리/NNG,20,4,24,3.260150872011168,Hawkish
수요/NNG;회복/NNG;지연/NNG,36,3,39,7.824362092826802,Hawkish
라운드/NNG,44,12,56,2.3907773061415227,Hawkish
끼친/VV,43,11,54,2.548845227208731,Hawkish
무겁/VA,54,15,69,2.34730862784804,Hawkish
코리아디스카운트/NNG;해소/NNG,36,13,49,1.8056220214215697,Hawkish
설비/NNG;투자/NNG;둔화/NNG,15,5,20,1.9560905232067003,Hawkish
공모금액/NNG,17,4,21,2.7711282412094924,Hawkish
중기부/NNG,296,30,326,6.43336438743537,Hawkish
환경부/NNG,24,6,30,2.6081206976089337,Hawkish
선택법/NNG,15,7,22,1.3972075165762146,Hawkish
폭넓/VA,89,44,133,1.3188792164045176,Hawkish
앞당기/VV,154,60,214,1.673544114299066,Hawkish
심지/NNG,14,7,21,1.3040603488044669,Hawkish
조합원/NNG,238,88,326,1.7634452444060404,Hawkish
근래/NNG,15,5,20,1.9560905232067003,Hawkish
파란불/NNG,15,6,21,1.6300754360055836,Hawkish
수혜/NNG,630,313,943,1.3123930027904378,Hawkish
구조물/NNG,32,7,39,2.9807093686959245,Hawkish
월래/NNG,62,14,76,2.887562200924177,Hawkish
영사관/NNG,65,19,84,2.230629544007641,Hawkish
현장검사/NNG,35,5,40,4.5642112208156345,Hawkish
물리/VV,22,5,27,2.8689327673698277,Hawkish
구매력/NNG,238,73,311,2.125797006955227,Hawkish
배달/NNG,203,88,291,1.5041150614051522,Hawkish
특별공급/NNG,75,14,89,3.4930187914405364,Hawkish
실적/NNG;좋/VA,32,9,41,2.318329508985719,Hawkish
보험증권/NNG,32,10,42,2.0864965580871475,Hawkish
니코틴/NNG,63,1,64,41.07790098734071,Hawkish
모두/NNG,275,118,393,1.5195618471238497,Hawkish
네트/NNG,16,5,21,2.0864965580871475,Hawkish
청신호/NNG,75,30,105,1.6300754360055836,Hawkish
캠페인/NNG,112,44,156,1.6597131712056852,Hawkish
판매가격/NNG;줄/VV,17,5,22,2.216902592967594,Hawkish
전국구/NNG,52,7,59,4.8436527241308776,Hawkish
느낀다/VV,27,8,35,2.200601838607538,Hawkish
제련/NNG,15,4,19,2.4451131540083755,Hawkish
이민자/NNG,34,1,35,22.16902592967594,Hawkish
밀레니얼세대/NNG,26,5,31,3.3905569068916144,Hawkish
추월/NNG,26,13,39,1.304060348804467,Hawkish
원부자재/NNG,16,4,20,2.608120697608934,Hawkish
방사능유출사태/NNG,20,1,21,13.04060348804467,Hawkish
화가/NNG,38,6,44,4.1295244378808125,Hawkish
육성/NNG,295,139,434,1.3838050463932294,Hawkish
약관/NNG,88,21,109,2.732316921304597,Hawkish
산업/NNG;상승/NNG,16,6,22,1.7387471317392895,Hawkish
배점/NNG,21,3,24,4.564211220815635,Hawkish
총회/NNG,82,33,115,1.6201961909388831,Hawkish
치이/VV,46,16,62,1.8745867514064212,Hawkish
현금창출력/NNG,58,19,77,1.9904079008068185,Hawkish
pf/NNG;대출/NNG;위험/NNG,22,3,25,4.7815546122830455,Hawkish
물가/NNG;충격/NNG,76,9,85,5.506032583841083,Hawkish
종일/NNG,17,4,21,2.7711282412094924,Hawkish
자민/NNG,13,6,19,1.4127320445381726,Hawkish
미/NNG;금리/NNG;하락/NNG,30,12,42,1.6300754360055836,Hawkish
관리비/NNG,58,22,80,1.7189886416058884,Hawkish
토끼/NNG,40,15,55,1.7387471317392893,Hawkish
판별/NNG,22,10,32,1.4344663836849136,Hawkish
금리/NNG;인상/NNG;어렵/VA,30,5,35,3.912181046413401,Hawkish
대출/NNG;한도/NNG;최대/NNG,16,3,19,3.477494263478579,Hawkish
고물가/NNG;고금리/NNG,105,38,143,1.801662324006172,Hawkish
자라/VV,15,6,21,1.6300754360055836,Hawkish
고도화/NNG,262,96,358,1.779499017639429,Hawkish
물건/NNG,450,154,604,1.9052829771493835,Hawkish
입간판/NNG,18,1,19,11.736543139240204,Hawkish
허덕이/VV,23,9,32,1.6662993345834856,Hawkish
고액자산가/NNG,109,50,159,1.421425780196869,Hawkish
꼽힌다/VV,489,222,711,1.4362286273995144,Hawkish
소재기업/NNG,26,13,39,1.304060348804467,Hawkish
우아/NNG,41,2,43,13.366618575245788,Hawkish
고용보고서/NNG,215,34,249,4.123131985190594,Hawkish
손실보상/NNG,73,4,77,11.899550682840763,Hawkish
회전/NNG,15,3,18,3.260150872011167,Hawkish
중개업소/NNG,22,6,28,2.3907773061415227,Hawkish
어린이집/NNG,36,10,46,2.3473086278480406,Hawkish
순이익/NNG;감소/NNG,125,13,138,6.269520907713784,Hawkish
어촌/NNG,101,1,102,65.85504761462559,Hawkish
오락/NNG,27,13,40,1.3542165160661772,Hawkish
희망가격/NNG,17,5,22,2.216902592967594,Hawkish
대주단/NNG,220,53,273,2.706540346575309,Hawkish
전조/NNG,19,7,26,1.7697961876632051,Hawkish
사선/NNG,55,12,67,2.988471632676904,Hawkish
효자/NNG,36,14,50,1.6766490198914574,Hawkish
경협/NNG,102,19,121,3.5003725152119904,Hawkish
내놓/VV,1416,693,2109,1.3322867632807542,Hawkish
건전/NNG,115,55,170,1.36333581920467,Hawkish
대출/NNG;성장/NNG,17,8,25,1.3855641206047462,Hawkish
본원/NNG,58,15,73,2.521183341021969,Hawkish
합치/VV,49,15,64,2.129965236380629,Hawkish
헐값/NNG,16,8,24,1.304060348804467,Hawkish
산업/NNG;경쟁력/NNG;강화/NNG,18,3,21,3.912181046413401,Hawkish
국제/NNG;유가/NNG;불안/NNG,27,9,36,1.9560905232067003,Hawkish
접어드/VV,15,7,22,1.3972075165762146,Hawkish
전문건설업체/NNG,12,5,17,1.5648724185653602,Hawkish
기대/NNG;확산/NNG,21,8,29,1.7115792078058631,Hawkish
재상장/NNG,23,3,26,4.998898003750457,Hawkish
위크/NNG,54,20,74,1.7604814708860304,Hawkish
시달리/VV,78,32,110,1.589323550105444,Hawkish
전망/NNG;상회/NNG,79,15,94,3.434025585185096,Hawkish
성장/NNG;수익성/NNG;개선/NNG,19,2,21,6.194286656821219,Hawkish
억누르/VV,32,10,42,2.0864965580871475,Hawkish
주택구입시/NNG,13,6,19,1.4127320445381726,Hawkish
카테고리/NNG,62,17,79,2.377992400761087,Hawkish
아시아개발은행/NNG,46,15,61,1.9995592015001824,Hawkish
훈장/NNG,21,1,22,13.692633662446903,Hawkish
쌓이/VV,138,68,206,1.3232377068751209,Hawkish
하위업종/NNG,12,5,17,1.5648724185653602,Hawkish
견본주택/NNG,81,35,116,1.5089841179023118,Hawkish
대통령령/NNG,14,3,17,3.042807480543756,Hawkish
평가손실/NNG,109,53,162,1.3409677171668577,Hawkish
이코노믹스/NNG,83,36,119,1.503291790982927,Hawkish
소비력/NNG,25,8,33,2.03759429500698,Hawkish
법인세법/NNG,16,2,18,5.216241395217868,Hawkish
가격/NNG;저점/NNG,17,2,19,5.542256482418985,Hawkish
청구자/NNG,40,11,51,2.371018816008122,Hawkish
상점가/NNG,40,9,49,2.8979118862321487,Hawkish
수출/NNG;양호/NNG,19,7,26,1.7697961876632051,Hawkish
매출/NNG;확대/NNG,67,13,80,3.3604632065345883,Hawkish
신주/NNG,40,9,49,2.8979118862321487,Hawkish
건설/NNG;수주/NNG;부진/NNG,24,5,29,3.1297448371307204,Hawkish
금선물/NNG,122,40,162,1.988692031926812,Hawkish
재세/NNG,71,6,77,7.715690397093097,Hawkish
둔화/NNG;부진/NNG,12,5,17,1.5648724185653602,Hawkish
높/VA;증가/NNG,71,18,89,2.571896799031032,Hawkish
따뜻/NNG,44,13,57,2.206871359515252,Hawkish
선방/NNG,168,78,246,1.4043726833278876,Hawkish
필지/NNG,176,3,179,38.25243689826437,Hawkish
투자심리/NNG;회복/NNG,63,24,87,1.711579207805863,Hawkish
편집/NNG,176,65,241,1.7654970876122011,Hawkish
사망자/NNG,13,6,19,1.4127320445381726,Hawkish
광고비/NNG,17,3,20,3.69483765494599,Hawkish
생산/NNG;증가/NNG,35,11,46,2.0746414640071067,Hawkish
점심/NNG,85,36,121,1.539515689560829,Hawkish
원천기술/NNG,14,3,17,3.042807480543756,Hawkish
최장기간/NNG,16,4,20,2.608120697608934,Hawkish
업소/NNG,47,9,56,3.405046466322774,Hawkish
건보/NNG,26,2,28,8.476392267229036,Hawkish
밑돈/NNG,90,29,119,2.023541920558656,Hawkish
작전/NNG,41,12,53,2.2277697625409645,Hawkish
내수/NNG;부진/NNG;우려/NNG,17,6,23,1.847418827472995,Hawkish
수익성/NNG;방어/NNG,21,2,23,6.846316831223453,Hawkish
양곡/NNG,18,9,27,1.3040603488044669,Hawkish
국고채/NNG;통안채/NNG;스프레드/NNG;확대/NNG,31,2,33,10.10646770323462,Hawkish
한도소진/NNG,19,6,25,2.0647622189404062,Hawkish
주주배정/NNG,22,11,33,1.3040603488044669,Hawkish
연대/NNG,61,9,70,4.419315626504027,Hawkish
els/NNG,1479,276,1755,3.494031260655447,Hawkish
기술혁신/NNG,55,23,78,1.5592025909618628,Hawkish
스트레스테스트/NNG,68,27,95,1.6421500688648842,Hawkish
용지/NNG,99,37,136,1.7446212774546248,Hawkish
여겨졌/VV,45,20,65,1.4670678924050256,Hawkish
해제/NNG,164,82,246,1.3040603488044669,Hawkish
충당금/NNG;적립/NNG;부담/NNG,18,7,25,1.6766490198914574,Hawkish
얼어붙/VV,136,43,179,2.062234970202413,Hawkish
전통시장/NNG,493,22,515,14.611403453650048,Hawkish
취재진/NNG,15,3,18,3.260150872011167,Hawkish
지양/NNG,37,17,54,1.4191244972283903,Hawkish
공급/NNG;촉진/NNG,18,1,19,11.736543139240204,Hawkish
경제/NNG;소비/NNG;회복/NNG,23,3,26,4.998898003750457,Hawkish
세정/NNG,36,9,45,2.6081206976089337,Hawkish
올바르/VA,45,21,66,1.3972075165762148,Hawkish
은행원/NNG,34,3,37,7.38967530989198,Hawkish
사외/NNG,25,1,26,16.300754360055837,Hawkish
생산/NNG;줄/VV,40,5,45,5.216241395217868,Hawkish
시장경제/NNG,52,18,70,1.8836427260508968,Hawkish
혁신기업/NNG,25,11,36,1.481886760005076,Hawkish
품목/NNG,630,284,914,1.4464049643429826,Hawkish
원달러/NNG;급락/NNG,18,1,19,11.736543139240204,Hawkish
쾌적/NNG,90,24,114,2.445113154008376,Hawkish
실적/NNG;회복/NNG,63,27,90,1.521403740271878,Hawkish
종속/NNG,25,9,34,1.811194928895093,Hawkish
명문가/NNG,153,7,160,14.25151666907739,Hawkish
담배/NNG,109,24,133,2.9613037087434773,Hawkish
팰리스/NNG,41,13,54,2.056402857730121,Hawkish
양국/NNG,204,91,295,1.4616940173412707,Hawkish
개포/NNG,54,3,57,11.736543139240204,Hawkish
초미/NNG,13,6,19,1.4127320445381726,Hawkish
합쳐/VV,84,37,121,1.4802847202645302,Hawkish
나이스/NNG,48,10,58,3.1297448371307204,Hawkish
버팀목/NNG,227,86,313,1.7210563905733371,Hawkish
연구개발비/NNG,24,9,33,1.738747131739289,Hawkish
팔라듐/NNG,22,7,29,2.049237690978448,Hawkish
명절/NNG,34,13,47,1.7053096868981492,Hawkish
최남단/NNG,14,4,18,2.282105610407817,Hawkish
고점/NNG;높/VV,19,4,23,3.0971433284106094,Hawkish
소규모기업/NNG,14,7,21,1.3040603488044669,Hawkish
혐의/NNG,88,34,122,1.6876075102175454,Hawkish
창출력/NNG,101,29,130,2.270863710849158,Hawkish
개발계획/NNG,34,10,44,2.216902592967594,Hawkish
실업보험/NNG,43,10,53,2.8037297499296043,Hawkish
단의/NNG,23,4,27,3.749173502812843,Hawkish
부품/NNG,397,145,542,1.785213649915081,Hawkish
프리/NNG,57,24,81,1.5485716642053045,Hawkish
달러인덱스/NNG;상승/NNG,18,9,27,1.3040603488044669,Hawkish
금리/NNG;인상/NNG;가능성/NNG;낮/VA,18,7,25,1.6766490198914574,Hawkish
이어질지/VV,78,33,111,1.541162230405279,Hawkish
불러오/VV,45,18,63,1.6300754360055838,Hawkish
둔화/NNG;추세/NNG,105,47,152,1.4566631555794578,Hawkish
수요/NNG;정체/NNG,25,5,30,3.260150872011168,Hawkish
크리스/NNG,22,10,32,1.4344663836849136,Hawkish
신선/NNG,32,8,40,2.608120697608934,Hawkish
금/NNG;가격/NNG;상승/NNG,13,6,19,1.4127320445381726,Hawkish
비상장주식/NNG,20,8,28,1.6300754360055838,Hawkish
토큰/NNG,129,39,168,2.1567151922535417,Hawkish
순환적/VAX,38,13,51,1.9059343559449904,Hawkish
남겨둔/VV,20,6,26,2.173433914674112,Hawkish
경제/NNG;강세/NNG,13,5,18,1.6952784534458072,Hawkish
주사/NNG,31,4,35,5.05323385161731,Hawkish
금리/NNG;상하단/NNG,14,7,21,1.3040603488044669,Hawkish
퇴근길/NNG,18,8,26,1.467067892405025,Hawkish
리딩뱅크/NNG,56,6,62,6.085614961087512,Hawkish
일환/NNG,194,74,268,1.7093764031626122,Hawkish
교환권/NNG,19,2,21,6.194286656821219,Hawkish
공약/NNG,381,170,551,1.4613146849838292,Hawkish
매출/NNG;신장/NNG,15,6,21,1.6300754360055836,Hawkish
악화/NNG;우려/NNG,57,20,77,1.8582859970463652,Hawkish
논거/NNG,19,7,26,1.7697961876632051,Hawkish
탐사/NNG,32,16,48,1.304060348804467,Hawkish
상장기업/NNG,82,29,111,1.8436715276201088,Hawkish
지하층/NNG,257,89,346,1.882828705858135,Hawkish
단타/NNG,43,10,53,2.8037297499296043,Hawkish
위험가중자산/NNG,42,20,62,1.3692633662446905,Hawkish
만든/VV,147,73,220,1.312992269001758,Hawkish
안동/NNG,35,1,36,22.82105610407817,Hawkish
가계/NNG;대출/NNG;증가/NNG;확대/NNG,28,5,33,3.651368976652508,Hawkish
자산/NNG;성장/NNG,32,16,48,1.304060348804467,Hawkish
경희궁/NNG,20,8,28,1.6300754360055838,Hawkish
리플/NNG,42,8,50,3.4231584156117263,Hawkish
진단/NNG,1359,592,1951,1.4968057550889111,Hawkish
원상/NNG,35,7,42,3.260150872011168,Hawkish
톡톡/MAG,22,3,25,4.7815546122830455,Hawkish
준법/NNG,30,10,40,1.9560905232067003,Hawkish
판매비/NNG,18,2,20,5.868271569620101,Hawkish
비용/NNG;인하/NNG,16,1,17,10.432482790435737,Hawkish
가까이/NNG,60,24,84,1.6300754360055836,Hawkish
제품/NNG,1312,514,1826,1.664326048279631,Hawkish
안대/NNG,80,33,113,1.580679210672081,Hawkish
상공회의소/NNG,31,14,45,1.4437811004620884,Hawkish
디지털금융/NNG,102,19,121,3.5003725152119904,Hawkish
지켜야/VV,14,6,20,1.521403740271878,Hawkish
gdp/NNG;증가/NNG,29,4,33,4.727218764416193,Hawkish
맞대/VV,18,7,25,1.6766490198914574,Hawkish
휘발유/NNG;가격/NNG;상승/NNG,17,7,24,1.58350185211971,Hawkish
본예산/NNG,21,7,28,1.9560905232067007,Hawkish
현대판/NNG,18,2,20,5.868271569620101,Hawkish
치러/VV,24,5,29,3.1297448371307204,Hawkish
원화/NNG;오르/VV,15,5,20,1.9560905232067003,Hawkish
워터/NNG,27,10,37,1.7604814708860304,Hawkish
휴장기간/NNG,21,2,23,6.846316831223453,Hawkish
공원/NNG,271,119,390,1.4848754391849184,Hawkish
마이크로컴퓨터/NNG,57,11,68,3.378701812811573,Hawkish
경제전/NNG,39,3,42,8.476392267229036,Hawkish
손해보험/NNG,123,27,150,2.970359683387952,Hawkish
사업/NNG,6601,2827,9428,1.5224800782557988,Hawkish
구인난/NNG,15,4,19,2.4451131540083755,Hawkish
분기점/NNG,44,12,56,2.3907773061415227,Hawkish
점화/NNG,28,9,37,2.0285383203625043,Hawkish
선전성분지수/NNG,13,5,18,1.6952784534458072,Hawkish
원방/NNG,28,7,35,2.6081206976089337,Hawkish
보상/NNG,235,113,348,1.3559919556152642,Hawkish
지하철/NNG,153,69,222,1.4458060388919092,Hawkish
진보/NNG,36,11,47,2.133916934407309,Hawkish
수요/NNG;축소/NNG,16,5,21,2.0864965580871475,Hawkish
소득/NNG;줄/VV,27,11,38,1.600437700805482,Hawkish
당근/NNG,30,15,45,1.3040603488044669,Hawkish
징역/NNG,24,10,34,1.5648724185653602,Hawkish
노호/NNG,83,3,86,18.039501491795125,Hawkish
철도망/NNG,22,3,25,4.7815546122830455,Hawkish
분산/NNG,157,69,226,1.4836048895818936,Hawkish
단지/NNG,1330,437,1767,1.9844396612241888,Hawkish
재추진/NNG,82,17,99,3.145086723587244,Hawkish
실차/NNG,26,1,27,16.952784534458072,Hawkish
순위/NNG,520,227,747,1.4936374039170108,Hawkish
삽입/NNG,14,4,18,2.282105610407817,Hawkish
땅값/NNG,59,16,75,2.404361268108236,Hawkish
사모발행/NNG,21,3,24,4.564211220815635,Hawkish
묻어두/VV,14,6,20,1.521403740271878,Hawkish
대명사/NNG,20,6,26,2.173433914674112,Hawkish
필두/NNG,94,28,122,2.188958442636069,Hawkish
시상/NNG,14,6,20,1.521403740271878,Hawkish
객실/NNG,28,6,34,3.042807480543756,Hawkish
매수비중/NNG,53,6,59,5.759599873886396,Hawkish
저축은행사태/NNG,54,17,71,2.071154671630624,Hawkish
붙여/VV,39,16,55,1.589323550105444,Hawkish
신입/NNG,68,10,78,4.433805185935188,Hawkish
불분명/NNG,24,11,35,1.4226112896048728,Hawkish
쟁점/NNG,48,22,70,1.4226112896048728,Hawkish
수요자/NNG,634,201,835,2.0566523909005774,Hawkish
포효/NNG,33,1,34,21.516995755273705,Hawkish
한시적/VAX;완화/NNG,12,5,17,1.5648724185653602,Hawkish
미뤄왔/VV,13,5,18,1.6952784534458072,Hawkish
독자/NNG,119,42,161,1.8474188274729948,Hawkish
굳이/MAG,120,55,175,1.422611289604873,Hawkish
융합/NNG,32,10,42,2.0864965580871475,Hawkish
토지/NNG,618,247,865,1.6313953351440498,Hawkish
산업단지/NNG,132,42,174,2.049237690978448,Hawkish
자금/NNG;조달/NNG;활성화/NNG,14,4,18,2.282105610407817,Hawkish
보태/VV,85,30,115,1.8474188274729948,Hawkish
겹친/VV,35,16,51,1.426316006504886,Hawkish
업황/NNG;회복/NNG,80,24,104,2.173433914674112,Hawkish
해상운송/NNG,23,10,33,1.499669401125137,Hawkish
편법/NNG,26,2,28,8.476392267229036,Hawkish
걸려/VV,41,16,57,1.6708273219057237,Hawkish
자금/NNG;조달/NNG;어렵/VA,25,6,31,2.71679239334264,Hawkish
전기차/NNG,1167,426,1593,1.7861953369187946,Hawkish
한꺼번에/MAG,81,36,117,1.467067892405025,Hawkish
원화자산/NNG,20,9,29,1.4489559431160743,Hawkish
금값/NNG,292,136,428,1.3999471391577367,Hawkish
점주/NNG,14,4,18,2.282105610407817,Hawkish
국군/NNG,28,1,29,18.256844883262534,Hawkish
기대/NNG;인플레이션/NNG;안정/NNG,15,5,20,1.9560905232067003,Hawkish
엇갈린다/VV,32,11,43,1.896815052806497,Hawkish
서부텍사스산원유/NNG,254,109,363,1.5194097642033697,Hawkish
베이스/NNG,77,29,106,1.7312525320335166,Hawkish
소비/NNG;위축/NNG,69,31,100,1.4512929688307776,Hawkish
따라붙/VV,18,6,24,1.9560905232067003,Hawkish
생산지/NNG,34,3,37,7.38967530989198,Hawkish
신차/NNG,154,68,222,1.4766565714403523,Hawkish
재매입/NNG,28,4,32,4.5642112208156345,Hawkish
센트/NNG,161,64,225,1.6402634074806188,Hawkish
성장/NNG;확대/NNG,18,3,21,3.912181046413401,Hawkish
일치/NNG,144,63,207,1.4903546843479625,Hawkish
황기/NNG,30,6,36,3.260150872011167,Hawkish
구조적/VAX;성장/NNG,17,5,22,2.216902592967594,Hawkish
경제부처/NNG,17,6,23,1.847418827472995,Hawkish
트랩/NNG,15,2,17,4.890226308016751,Hawkish
모델링/NNG,18,4,22,2.9341357848100507,Hawkish
이노베이션/NNG,36,7,43,3.353298039782915,Hawkish
고정/NNG;금리/NNG;선호/NNG,20,2,22,6.520301744022335,Hawkish
헤쳐/VV,14,6,20,1.521403740271878,Hawkish
경제관계장관회의/NNG,48,17,65,1.8410263747827769,Hawkish
메스/NNG,14,3,17,3.042807480543756,Hawkish
자산군/NNG,54,24,78,1.467067892405025,Hawkish
아파트형공장/NNG,12,6,18,1.3040603488044669,Hawkish
물가/NNG;높/VA,72,20,92,2.3473086278480406,Hawkish
성적표/NNG,125,36,161,2.263993661118866,Hawkish
인플레이션/NNG;예상/NNG;높/VA,16,4,20,2.608120697608934,Hawkish
fed/NNG;금리/NNG;인하/NNG,1117,523,1640,1.39257687343651,Hawkish
내수/NNG;상승/NNG,35,3,38,7.607018701359391,Hawkish
조달계획/NNG,30,12,42,1.6300754360055836,Hawkish
심지어/MAG,117,48,165,1.589323550105444,Hawkish
상회/NNG,1451,706,2157,1.3400790128295197,Hawkish
양육비/NNG,27,2,29,8.802407354430152,Hawkish
대학원/NNG,128,53,181,1.574714383461998,Hawkish
금채/NNG,20,8,28,1.6300754360055838,Hawkish
사원/NNG,32,11,43,1.896815052806497,Hawkish
지출/NNG;늘/VV,46,14,60,2.142384858750196,Hawkish
강재/NNG,19,1,20,12.388573313642436,Hawkish
자연재해/NNG,28,9,37,2.0285383203625043,Hawkish
거두/VV,142,65,207,1.4244351502325716,Hawkish
상장/NNG,1458,623,2081,1.5259389956315514,Hawkish
기업/NNG;부담/NNG,28,8,36,2.282105610407817,Hawkish
정체성/NNG,35,10,45,2.282105610407817,Hawkish
자산/NNG;건전성/NNG;저하/NNG,22,6,28,2.3907773061415227,Hawkish
커서/NNG,40,20,60,1.304060348804467,Hawkish
부국/NNG,22,4,26,3.5861659592122845,Hawkish
환율정책/NNG,17,3,20,3.69483765494599,Hawkish
위험/NNG;금리/NNG;인하/NNG,28,10,38,1.8256844883262535,Hawkish
쪼그라들/VV,104,38,142,1.784503635206113,Hawkish
치유/NNG,53,5,58,6.911519848663676,Hawkish
예방/NNG,351,101,452,2.265966249655287,Hawkish
항목/NNG,441,197,638,1.4596208472659136,Hawkish
금융사/NNG,769,319,1088,1.57182195647435,Hawkish
암보험/NNG,47,7,54,4.377916885272139,Hawkish
강북/NNG,108,34,142,2.071154671630624,Hawkish
법사/NNG,24,10,34,1.5648724185653602,Hawkish
성비/NNG,14,4,18,2.282105610407817,Hawkish
금리/NNG;내리/VV;않/VX,42,9,51,3.0428074805437566,Hawkish
종합지원센터/NNG,16,5,21,2.0864965580871475,Hawkish
우편/NNG,14,5,19,1.8256844883262535,Hawkish
출렁였/VV,34,11,45,2.0153659936069035,Hawkish
전경/NNG,35,16,51,1.426316006504886,Hawkish
입주권/NNG,24,8,32,1.9560905232067003,Hawkish
재정/NNG;확장/NNG,18,7,25,1.6766490198914574,Hawkish
체인저/NNG,13,5,18,1.6952784534458072,Hawkish
하방/NNG;압력/NNG;크/VV,32,10,42,2.0864965580871475,Hawkish
트인/VV,32,8,40,2.608120697608934,Hawkish
과한/VA,12,5,17,1.5648724185653602,Hawkish
경기/NNG;전망/NNG;부정적/VAX,21,2,23,6.846316831223453,Hawkish
집중투자/NNG,44,21,65,1.3661584606522987,Hawkish
갈지/VV,43,14,57,2.002664107092574,Hawkish
디딤돌/NNG,195,66,261,1.926452788006599,Hawkish
입찰가격/NNG,25,4,29,4.075188590013959,Hawkish
브레이크/NNG,25,12,37,1.3583961966713198,Hawkish
나서/VV,3203,1470,4673,1.4207160874900366,Hawkish
이미/MAG;금리/NNG;인상/NNG,14,5,19,1.8256844883262535,Hawkish
회의체/NNG,18,4,22,2.9341357848100507,Hawkish
핑계/NNG,15,6,21,1.6300754360055836,Hawkish
운동장/NNG,17,7,24,1.58350185211971,Hawkish
물가/NNG;고공행진/NNG,14,4,18,2.282105610407817,Hawkish
온화/NNG,19,4,23,3.0971433284106094,Hawkish
당황/NNG,17,7,24,1.58350185211971,Hawkish
판관비/NNG,108,18,126,3.9121810464134006,Hawkish
럭셔리/NNG,52,24,76,1.4127320445381726,Hawkish
정반대/NNG,61,26,87,1.529763101482163,Hawkish
금리/NNG;인하/NNG;가능성/NNG;크/VV,18,9,27,1.3040603488044669,Hawkish
선보였/VV,109,51,160,1.3935546864675188,Hawkish
eps/NNG,282,138,420,1.3324094868219556,Hawkish
징벌/NNG,43,7,50,4.005328214185148,Hawkish
학습효과/NNG,27,13,40,1.3542165160661772,Hawkish
소비자/NNG;물가/NNG;상승률/NNG;점차/MAG;낮/VA,27,2,29,8.802407354430152,Hawkish
얽힌/VV,14,5,19,1.8256844883262535,Hawkish
소규모/NNG,243,96,339,1.6504513789556536,Hawkish
이직/NNG,14,6,20,1.521403740271878,Hawkish
신디케이트론/NNG,174,69,243,1.644250005014328,Hawkish
재판부/NNG,18,8,26,1.467067892405025,Hawkish
수익/NNG,2489,1243,3732,1.3056340338593395,Hawkish
품귀/NNG,26,12,38,1.4127320445381726,Hawkish
점포/NNG,422,91,513,3.023700369205962,Hawkish
예상/NNG;늦/VV,39,15,54,1.695278453445807,Hawkish
환테크/NNG,23,1,24,14.996694011251371,Hawkish
원화/NNG;떨어/VV,25,10,35,1.6300754360055838,Hawkish
패러다임/NNG,58,29,87,1.304060348804467,Hawkish
제조사/NNG,164,42,206,2.546022585761102,Hawkish
스타/NNG,304,92,396,2.1545344893291194,Hawkish
디자인/NNG,236,42,278,3.663788599022074,Hawkish
현수막/NNG,18,9,27,1.3040603488044669,Hawkish
채광/NNG,36,7,43,3.353298039782915,Hawkish
주택청약/NNG,30,11,41,1.7782641120060911,Hawkish
박미/NNG,14,4,18,2.282105610407817,Hawkish
외연/NNG,24,10,34,1.5648724185653602,Hawkish
투자계획/NNG,105,45,150,1.521403740271878,Hawkish
전망/NNG;크/VV,22,4,26,3.5861659592122845,Hawkish
현관/NNG,42,5,47,5.477053464978762,Hawkish
강동/MAG,18,2,20,5.868271569620101,Hawkish
상자/NNG,146,52,198,1.830700105052425,Hawkish
효율/NNG,567,196,763,1.8862301473778895,Hawkish
오르내리/VV,48,17,65,1.8410263747827769,Hawkish
첫발/NNG,30,5,35,3.912181046413401,Hawkish
분업/NNG,18,4,22,2.9341357848100507,Hawkish
페어/NNG,24,3,27,5.2162413952178674,Hawkish
놀라/VV,35,12,47,1.901754675339848,Hawkish
간사/NNG,20,4,24,3.260150872011168,Hawkish
적체/NNG,111,33,144,2.1931924048075127,Hawkish
대장/NNG,162,44,206,2.400656551208223,Hawkish
준공/NNG,532,177,709,1.9597743095027584,Hawkish
궤도/NNG,96,21,117,2.980709368695924,Hawkish
위험자산/NNG;선호/NNG,50,24,74,1.3583961966713198,Hawkish
소비자후생/NNG,42,7,49,3.9121810464134015,Hawkish
공감대/NNG,86,33,119,1.6992301514724872,Hawkish
커넥트/NNG,12,6,18,1.3040603488044669,Hawkish
치닫/VV,50,22,72,1.481886760005076,Hawkish
잔금대출/NNG,43,12,55,2.33644145827467,Hawkish
전방/NNG,97,40,137,1.5811731729254164,Hawkish
차전/NNG,28,7,35,2.6081206976089337,Hawkish
이자비용/NNG;증가/NNG,42,14,56,1.9560905232067007,Hawkish
포격/NNG,16,3,19,3.477494263478579,Hawkish
사모사채/NNG,37,7,44,3.446445207554663,Hawkish
특별회계/NNG,16,6,22,1.7387471317392895,Hawkish
오로지/MAG,19,9,28,1.3765081459602708,Hawkish
잔치/NNG,24,9,33,1.738747131739289,Hawkish
중론/NNG,51,19,70,1.7501862576059952,Hawkish
독점/NNG,89,42,131,1.3816829886142563,Hawkish
확고히/MAG,55,4,59,8.965414898030712,Hawkish
타자/NNG,12,5,17,1.5648724185653602,Hawkish
엔저/NNG,377,131,508,1.8764532499972677,Hawkish
비트코인/NNG,1874,723,2597,1.6900477826138114,Hawkish
처벌/NNG,184,40,224,2.999338802250274,Hawkish
부활/NNG,105,44,149,1.55598109800533,Hawkish
소부/NNG,58,22,80,1.7189886416058884,Hawkish
무형자산/NNG,18,5,23,2.3473086278480406,Hawkish
정무위/NNG,23,4,27,3.749173502812843,Hawkish
정비계획/NNG,22,2,24,7.172331918424569,Hawkish
힘썼/VV,17,5,22,2.216902592967594,Hawkish
그만/MAG,15,6,21,1.6300754360055836,Hawkish
충족/NNG,556,233,789,1.5559174977152008,Hawkish
인건비/NNG;증가/NNG,36,7,43,3.353298039782915,Hawkish
조속/NNG,66,26,92,1.6551535196364389,Hawkish
물가/NNG;상승률/NNG;높/VA;금리/NNG;인하/NNG,22,1,23,14.344663836849138,Hawkish
챙겨야/VV,13,4,17,2.119098066807259,Hawkish
압류/NNG,70,24,94,1.901754675339848,Hawkish
찍기/NNG,13,6,19,1.4127320445381726,Hawkish
신조/NNG,27,4,31,4.401203677215076,Hawkish
보여서/VV,15,3,18,3.260150872011167,Hawkish
자랑/NNG,84,24,108,2.2821056104078177,Hawkish
주택사업/NNG;위험/NNG,20,1,21,13.04060348804467,Hawkish
이룬다/VV,12,5,17,1.5648724185653602,Hawkish
알리/NNG,22,9,31,1.5938515374276818,Hawkish
불투명/NNG,322,119,441,1.7643169425001612,Hawkish
fed/NNG;금리/NNG;인하/NNG;기대/NNG;약화/NNG,34,3,37,7.38967530989198,Hawkish
금리/NNG;인하/NNG;기대/NNG;후퇴/NNG,240,93,333,1.682658514586409,Hawkish
가격/NNG;불안정/NNG,23,1,24,14.996694011251371,Hawkish
입안/NNG,13,4,17,2.119098066807259,Hawkish
토론회/NNG,279,38,317,4.787274175216399,Hawkish
망고/NNG,26,2,28,8.476392267229036,Hawkish
입찰공고/NNG,23,2,25,7.498347005625686,Hawkish
산지/NNG,26,5,31,3.3905569068916144,Hawkish
순부채비율/NNG,18,2,20,5.868271569620101,Hawkish
자연스레/MAG,36,18,54,1.3040603488044669,Hawkish
시설관리/NNG,17,7,24,1.58350185211971,Hawkish
포메이션/NNG,17,2,19,5.542256482418985,Hawkish
최고조/NNG,28,10,38,1.8256844883262535,Hawkish
청구서/NNG,17,4,21,2.7711282412094924,Hawkish
스테이플/NNG,19,4,23,3.0971433284106094,Hawkish
쓰레기/NNG,31,13,44,1.5548411851130184,Hawkish
수영장/NNG,26,10,36,1.6952784534458072,Hawkish
파트너십/NNG,79,34,113,1.51501128758166,Hawkish
사안/NNG,184,80,264,1.499669401125137,Hawkish
정산/NNG,52,25,77,1.3562227627566457,Hawkish
담겼/VV,120,28,148,2.794415033152429,Hawkish
언서/NNG,17,4,21,2.7711282412094924,Hawkish
대지/NNG,18,8,26,1.467067892405025,Hawkish
근로시간/NNG,92,31,123,1.9350572917743705,Hawkish
업력/NNG,44,4,48,7.172331918424569,Hawkish
인프라펀드/NNG,14,3,17,3.042807480543756,Hawkish
자금/NNG;부담/NNG,38,15,53,1.6518097751523249,Hawkish
원할/VV,33,12,45,1.793082979606142,Hawkish
양도담보/NNG,12,5,17,1.5648724185653602,Hawkish
순서/NNG,85,42,127,1.319584876766425,Hawkish
매출/NNG;하락/NNG,21,3,24,4.564211220815635,Hawkish
하락/NNG;내리/VV,31,6,37,3.368822567744873,Hawkish
건수/NNG,1316,632,1948,1.3577084011287015,Hawkish
투자조합/NNG,14,3,17,3.042807480543756,Hawkish
분배금/NNG,187,33,220,3.6948376549459896,Hawkish
영업이익/NNG;넘/VV,13,4,17,2.119098066807259,Hawkish
이뤄지며/VV,25,6,31,2.71679239334264,Hawkish
팽창/NNG,59,17,76,2.262928252337163,Hawkish
변동성/NNG;크/VV,157,65,222,1.5749036520177022,Hawkish
탄력/NNG,326,143,469,1.4864464115743226,Hawkish
만점/NNG,26,13,39,1.304060348804467,Hawkish
입히/VV,18,9,27,1.3040603488044669,Hawkish
양면/NNG,18,9,27,1.3040603488044669,Hawkish
공포/NNG,171,64,235,1.7421431222309678,Hawkish
석상/NNG,15,2,17,4.890226308016751,Hawkish
승승장구/NNG,17,7,24,1.58350185211971,Hawkish
자금/NNG;마련/NNG;부담/NNG,14,7,21,1.3040603488044669,Hawkish
증설/NNG,102,25,127,2.6602831115611125,Hawkish
장착/NNG,21,10,31,1.3692633662446905,Hawkish
국제/NNG;유가/NNG;원자재/NNG;가격/NNG;상승/NNG,13,4,17,2.119098066807259,Hawkish
대손/NNG,30,5,35,3.912181046413401,Hawkish
보훈/NNG,32,4,36,5.216241395217868,Hawkish
경기/NNG;위축/NNG,52,19,71,1.784503635206113,Hawkish
보편/NNG,54,20,74,1.7604814708860304,Hawkish
예술품/NNG,18,1,19,11.736543139240204,Hawkish
자금사정/NNG,248,84,332,1.9250414672827847,Hawkish
투자/NNG;비중/NNG;높/VV,13,4,17,2.119098066807259,Hawkish
노려볼/VV,21,8,29,1.7115792078058631,Hawkish
경기/NNG;회복/NNG;모멘텀/NNG,16,7,23,1.4903546843479625,Hawkish
책임자/NNG,190,53,243,2.3374666629514027,Hawkish
정상/NNG,570,193,763,1.925684971032503,Hawkish
성사/NNG,100,45,145,1.4489559431160743,Hawkish
물류비/NNG,39,7,46,3.632739543098158,Hawkish
불확실성/NNG;해소/NNG,93,45,138,1.3475290270979492,Hawkish
나날이/MAG,21,7,28,1.9560905232067007,Hawkish
백성/NNG,17,3,20,3.69483765494599,Hawkish
판매비중/NNG,82,18,100,2.970359683387952,Hawkish
수출/NNG;개선/NNG,57,22,79,1.6893509064057866,Hawkish
손실액/NNG,60,20,80,1.9560905232067003,Hawkish
고물가/NNG,986,467,1453,1.376663280429555,Hawkish
수익/NNG;오르/VV,39,18,57,1.4127320445381726,Hawkish
펀드운용사/NNG,21,4,25,3.4231584156117263,Hawkish
매진/NNG,55,22,77,1.6300754360055838,Hawkish
전망/NNG;어둡/VA,30,7,37,2.794415033152429,Hawkish
순자산/NNG;늘/VV,16,4,20,2.608120697608934,Hawkish
에르/NNG,28,11,39,1.6597131712056852,Hawkish
테스트/NNG,168,69,237,1.5875517289793513,Hawkish
탄소/NNG,112,36,148,2.0285383203625043,Hawkish
직책/NNG,19,6,25,2.0647622189404062,Hawkish
모태펀드/NNG,50,2,52,16.300754360055837,Hawkish
거꾸로/MAG,22,10,32,1.4344663836849136,Hawkish
어닝서프라이즈/NNG,201,61,262,2.148492869751622,Hawkish
취하/VV,172,82,254,1.3676730487461484,Hawkish
실적/NNG;견인/NNG,25,8,33,2.03759429500698,Hawkish
주문/NNG,659,325,984,1.322116569018683,Hawkish
통과/NNG,614,287,901,1.3949356344354404,Hawkish
분절/NNG,57,3,60,12.388573313642436,Hawkish
세컨드/NNG,46,3,49,9.997796007500916,Hawkish
가격/NNG;강세/NNG,30,11,41,1.7782641120060911,Hawkish
직격탄/NNG,114,44,158,1.6893509064057866,Hawkish
기주/NNG,15,5,20,1.9560905232067003,Hawkish
파이/NNG,86,36,122,1.55762763884978,Hawkish
빈번/NNG,53,26,79,1.329138432435322,Hawkish
지부/NNG,15,7,22,1.3972075165762146,Hawkish
강연자/NNG,14,3,17,3.042807480543756,Hawkish
우호/NNG,16,6,22,1.7387471317392895,Hawkish
생산/NNG;비용/NNG;증가/NNG,40,6,46,4.346867829348224,Hawkish
넓혔/VV,25,10,35,1.6300754360055838,Hawkish
비용/NNG;증가/NNG,134,48,182,1.8202509035395689,Hawkish
주채권은행/NNG,61,11,72,3.615803694412386,Hawkish
기대/NNG;우려/NNG,14,7,21,1.3040603488044669,Hawkish
변할지/VV,40,4,44,6.520301744022335,Hawkish
급선무/NNG,13,5,18,1.6952784534458072,Hawkish
트럭/NNG,50,14,64,2.328679194293691,Hawkish
건재/NNG,15,4,19,2.4451131540083755,Hawkish
눈높이/NNG,132,58,190,1.483930741743014,Hawkish
기술원/NNG,20,9,29,1.4489559431160743,Hawkish
금융분쟁조정위원회/NNG,24,1,25,15.648724185653604,Hawkish
초읽기/NNG,15,3,18,3.260150872011167,Hawkish
예상/NNG;부진/NNG,34,17,51,1.304060348804467,Hawkish
다다르/VV,20,2,22,6.520301744022335,Hawkish
옮긴/VV,19,6,25,2.0647622189404062,Hawkish
충당금적립전/NNG,20,1,21,13.04060348804467,Hawkish
감내/NNG,156,53,209,1.91918315484431,Hawkish
도착/NNG,36,8,44,2.9341357848100507,Hawkish
생산/NNG;급증/NNG,17,1,18,11.08451296483797,Hawkish
초저위험/NNG,13,5,18,1.6952784534458072,Hawkish
꺼낸/VV,12,6,18,1.3040603488044669,Hawkish
대기자금/NNG,193,86,279,1.4632770192980358,Hawkish
덜하/VA,38,18,56,1.3765081459602708,Hawkish
작황/NNG,60,19,79,2.0590426560070534,Hawkish
국가자산/NNG,20,1,21,13.04060348804467,Hawkish
가칭/NNG,69,8,77,5.623760254219264,Hawkish
비농업/NNG;신규/NNG;고용/NNG;증가/NNG,15,2,17,4.890226308016751,Hawkish
수치/NNG,1896,907,2803,1.3630090525541727,Hawkish
이자수익/NNG;확보/NNG,24,6,30,2.6081206976089337,Hawkish
은행법/NNG,61,29,90,1.3715117461564224,Hawkish
실적/NNG;예상/NNG;웃돌/VV,15,4,19,2.4451131540083755,Hawkish
지표/NNG;금리/NNG;인하/NNG,22,10,32,1.4344663836849136,Hawkish
이익/NNG;증가/NNG,37,7,44,3.446445207554663,Hawkish
여진/NNG,20,8,28,1.6300754360055838,Hawkish
사거리/NNG,19,6,25,2.0647622189404062,Hawkish
법규/NNG,22,11,33,1.3040603488044669,Hawkish
역삼/NNG,15,6,21,1.6300754360055836,Hawkish
경쟁업체/NNG,34,6,40,3.69483765494599,Hawkish
옵션/NNG,277,75,352,2.408164777458916,Hawkish
초콜릿/NNG,20,9,29,1.4489559431160743,Hawkish
금리/NNG;우려/NNG,22,10,32,1.4344663836849136,Hawkish
장악/NNG,43,18,61,1.55762763884978,Hawkish
구역/NNG,548,146,694,2.4473461340576983,Hawkish
호평/NNG,57,23,80,1.6159008669968395,Hawkish
회수의문/NNG,64,23,87,1.8143448331192584,Hawkish
통인/NNG,20,2,22,6.520301744022335,Hawkish
해고/NNG,96,34,130,1.8410263747827769,Hawkish
웍스/NNG,25,6,31,2.71679239334264,Hawkish
회천/NNG,20,2,22,6.520301744022335,Hawkish
원화/NNG;환율/NNG;내리/VV,15,4,19,2.4451131540083755,Hawkish
경영관리/NNG,27,8,35,2.200601838607538,Hawkish
계획안/NNG,18,6,24,1.9560905232067003,Hawkish
턱없이/MAG,27,8,35,2.200601838607538,Hawkish
리소스/NNG,15,3,18,3.260150872011167,Hawkish
북측/NNG,18,3,21,3.912181046413401,Hawkish
편승/NNG,32,6,38,3.477494263478579,Hawkish
세입자/NNG,246,59,305,2.7186342864906687,Hawkish
양극화/NNG,307,149,456,1.3434447217549377,Hawkish
브로커리지/NNG,107,34,141,2.05197731355997,Hawkish
반사이익/NNG,64,23,87,1.8143448331192584,Hawkish
담겨/VV,41,16,57,1.6708273219057237,Hawkish
개별주식/NNG,17,7,24,1.58350185211971,Hawkish
겉면/NNG,46,1,47,29.993388022502742,Hawkish
착한/VA,36,9,45,2.6081206976089337,Hawkish
노하우/NNG,210,78,288,1.7554658541598591,Hawkish
자산/NNG;늘/VV,25,10,35,1.6300754360055838,Hawkish
급감/NNG,583,272,855,1.3975499693989049,Hawkish
산업/NNG;생산/NNG;감소/NNG,16,5,21,2.0864965580871475,Hawkish
다자녀/NNG,88,39,127,1.4712475730101675,Hawkish
기준가격/NNG,102,25,127,2.6602831115611125,Hawkish
세액/NNG,52,19,71,1.784503635206113,Hawkish
들썩/MAG,25,7,32,2.328679194293691,Hawkish
박차/NNG,77,28,105,1.793082979606142,Hawkish
주택가격/NNG;회복/NNG,21,5,26,2.738526732489381,Hawkish
물가/NNG;시장/NNG;예상/NNG;웃돌/VV,30,3,33,6.520301744022334,Hawkish
약자/NNG,41,15,56,1.7822158100327714,Hawkish
산업별/NNG,13,4,17,2.119098066807259,Hawkish
배상액/NNG,32,16,48,1.304060348804467,Hawkish
신저가/NNG,86,28,114,2.002664107092574,Hawkish
벤치마킹/NNG,17,4,21,2.7711282412094924,Hawkish
공수/NNG,12,5,17,1.5648724185653602,Hawkish
디자이너/NNG,16,7,23,1.4903546843479625,Hawkish
호소/NNG,76,22,98,2.252467875207716,Hawkish
소비/NNG;감소/NNG,39,13,52,1.9560905232067003,Hawkish
웨이/NNG,36,15,51,1.5648724185653602,Hawkish
특강/NNG,33,6,39,3.586165959212284,Hawkish
접촉/NNG,27,9,36,1.9560905232067003,Hawkish
나침반/NNG,18,8,26,1.467067892405025,Hawkish
자재/NNG,326,52,378,4.087727631829387,Hawkish
지우/VV,23,8,31,1.8745867514064212,Hawkish
경기/NNG;호조/NNG,78,21,99,2.4218263620654388,Hawkish
처해/VV,51,24,75,1.385564120604746,Hawkish
원가/NNG;상승/NNG,76,19,95,2.608120697608934,Hawkish
상용/NNG,15,5,20,1.9560905232067003,Hawkish
매매가격지수/NNG,26,6,32,2.825464089076345,Hawkish
경영학/NNG,23,7,30,2.142384858750196,Hawkish
적극/NNG,715,343,1058,1.359188264424481,Hawkish
제품/NNG;가격/NNG;오르/VV,12,5,17,1.5648724185653602,Hawkish
원만/NNG,28,4,32,4.5642112208156345,Hawkish
폭발/NNG;성장/NNG,15,6,21,1.6300754360055836,Hawkish
과실/NNG,65,9,74,4.7091068151272415,Hawkish
기법/NNG,53,18,71,1.9198666246287983,Hawkish
총괄/NNG,310,97,407,2.083807773862808,Hawkish
주목도/NNG,26,3,29,5.65092817815269,Hawkish
고정이하여신/NNG,152,69,221,1.436356326219413,Hawkish
봄철/NNG,17,2,19,5.542256482418985,Hawkish
물가/NNG;뛰/VV,12,5,17,1.5648724185653602,Hawkish
누리/VV,444,208,652,1.39183364151246,Hawkish
출연금/NNG,104,10,114,6.781113813783229,Hawkish
조율/NNG,114,32,146,2.322857496307957,Hawkish
인공/NNG,21,3,24,4.564211220815635,Hawkish
인위적/VAX,51,23,74,1.445806038891909,Hawkish
스테이/NNG,44,16,60,1.7930829796061425,Hawkish
부의/NNG,42,6,48,4.564211220815635,Hawkish
원리/NNG,46,16,62,1.8745867514064212,Hawkish
연체율/NNG;급등/NNG,30,11,41,1.7782641120060911,Hawkish
메인/VV,32,6,38,3.477494263478579,Hawkish
하반/NNG,39,10,49,2.542917680168711,Hawkish
부채/NNG;상환능력/NNG;악화/NNG,15,3,18,3.260150872011167,Hawkish
내수/NNG;부양/NNG,29,5,34,3.7817750115329543,Hawkish
차갑/VA,51,10,61,3.3253538894513905,Hawkish
양가/NNG,45,12,57,2.445113154008376,Hawkish
침구/NNG,26,1,27,16.952784534458072,Hawkish
가상화폐/NNG,137,57,194,1.5671602437387016,Hawkish
비둘기/NNG;완화/NNG,26,8,34,2.119098066807259,Hawkish
포문/NNG,12,5,17,1.5648724185653602,Hawkish
구조화/NNG,349,91,440,2.500643196333841,Hawkish
인스타그램/NNG,27,5,32,3.5209629417720607,Hawkish
최우선/NNG,203,83,286,1.594724402453655,Hawkish
근로/NNG,134,47,181,1.85897964616807,Hawkish
저마다/MAG,16,2,18,5.216241395217868,Hawkish
물거품/NNG,15,6,21,1.6300754360055836,Hawkish
인플레이션/NNG;악화/NNG,16,2,18,5.216241395217868,Hawkish
고유가/NNG,295,101,396,1.904444568798603,Hawkish
파이프라인/NNG,33,13,46,1.6551535196364389,Hawkish
요구자본/NNG,40,12,52,2.173433914674112,Hawkish
계산기/NNG,17,3,20,3.69483765494599,Hawkish
만난/VV,74,30,104,1.6083410968588423,Hawkish
외곽/NNG,76,35,111,1.4158369501305643,Hawkish
후기/NNG,33,13,46,1.6551535196364389,Hawkish
근원지수/NNG,15,5,20,1.9560905232067003,Hawkish
암초/NNG,15,3,18,3.260150872011167,Hawkish
꼼수/NNG,18,4,22,2.9341357848100507,Hawkish
암울/NNG,29,7,36,2.701267865380682,Hawkish
의녀/NNG,22,1,23,14.344663836849138,Hawkish
투자심리/NNG;살/VV,36,11,47,2.133916934407309,Hawkish
국민주택채권/NNG,28,3,31,6.085614961087512,Hawkish
베이/NNG,45,17,62,1.7259622263588537,Hawkish
납기/NNG,26,1,27,16.952784534458072,Hawkish
일본인/NNG,13,4,17,2.119098066807259,Hawkish
성패/NNG,23,10,33,1.499669401125137,Hawkish
기술력/NNG,136,37,173,2.3966514518568585,Hawkish
씀씀이/NNG,16,6,22,1.7387471317392895,Hawkish
피난처/NNG,22,4,26,3.5861659592122845,Hawkish
양호/NNG;회복/NNG,30,12,42,1.6300754360055836,Hawkish
연습장/NNG,33,11,44,1.9560905232067003,Hawkish
위험/NNG;선호/NNG;회복/NNG,15,5,20,1.9560905232067003,Hawkish
맞물린/VV,33,13,46,1.6551535196364389,Hawkish
지역기업/NNG,37,12,49,2.010426371073553,Hawkish
몰려들/VV,31,11,42,1.8375395824062943,Hawkish
경기/NNG;긍정적/VAX,24,8,32,1.9560905232067003,Hawkish
이자/NNG;부담/NNG;늘/VV,19,4,23,3.0971433284106094,Hawkish
이민/NNG,138,36,174,2.499449001875228,Hawkish
변동성/NNG;높/VV,12,6,18,1.3040603488044669,Hawkish
고점/NNG;넘/VV,16,6,22,1.7387471317392895,Hawkish
일몰/NNG,107,15,122,4.651148577402599,Hawkish
원자력발전/NNG,15,6,21,1.6300754360055836,Hawkish
수요/NNG;많/VA,57,22,79,1.6893509064057866,Hawkish
강국/NNG,40,17,57,1.5341886456523142,Hawkish
빈티지/NNG,22,10,32,1.4344663836849136,Hawkish
대출/NNG;최대/NNG,17,7,24,1.58350185211971,Hawkish
계약자/NNG,107,31,138,2.250555763259322,Hawkish
ecb/NNG;금리/NNG;내리/VV,26,6,32,2.825464089076345,Hawkish
저항/NNG,87,11,98,5.156965924817665,Hawkish
수요/NNG;크/VV,46,14,60,2.142384858750196,Hawkish
선사/NNG,322,31,353,6.772700521210297,Hawkish
공문/NNG,19,9,28,1.3765081459602708,Hawkish
